apheresis	aphérèse 
bharadvaja	bharadvāja
dyslipidemia	dyslipidémie
endocarditis	endocardite
prevalence	prévalence
fenarimol	fénarimol
ribena	ribena
nephron	néphron
well-being	bien-être
millimetre	millimètre
baltimore	baltimore
diltiazem	diltiazem
timolol	timolol
heart	cœur
birmingham	birmingham
metonymy	métonymie
liver	foie
red	rouge
ea-3167	ea-3167
consciousness	conscience
dermatofibroma	histiocytofibrome
neodymium	néodyme
kif4a	kif4a
geometry	géométrie
erythromelalgia	érythromélalgie
barbiturate	barbiturique
mirtazapine	mirtazapine
n-nitrosodimethylamine	n-nitrosodiméthylamine
bayer	bayer 
catechin	catéchine
cytosol	cytosol
kirsch	kirsch
thioacetamide	thioacétamide
lansoprazole	lansoprazole
taxonomy 	taxonomie
homunculus	homoncule 
dispensary	dispensaire
ulama	ouléma
itraconazole	itraconazole
mecamylamine	mécamylamine
thrombocythemia	thrombocytose
highball	highball 
oceania	océanie
transcription 	transcription 
chemoreceptor	chimiorécepteur
primidone	primidone
cardiomegaly	cardiomégalie
xenophon	xénophon
iraq	irak
neuron	neurone
tamsulosin	tamsulosine
sacrum	sacrum
lusitropy	lusitrope
headache	céphalée
triatominae	triatominae
abiogenesis	abiogenèse
vlorë	vlora
irrigation	irrigation
420 	420 
ehealth	e-santé
sclerosis 	sclérose
naproxen	naproxène
ricin	ricine
doxapram	doxapram
autoantibody	auto-anticorps
crackles	crépitant
macuá	macuá
pramana	pramana
claw	griffe 
kassites	kassites
mosquito	moustique
corfu	corfou
wheeze	sibilance
angiotensin	angiotensine
hamites	hamites
catheter	cathéter
dust	poussière
microcirculation	microcirculation
chlorophyll	chlorophylle
nhs 	nhs
wikidata	wikidata
haptoglobin	haptoglobine
frunevetmab	frunévetmab
nocardia	nocardia
agni	agni 
vinca	pervenche
p21	p21
paraoxon	paraoxone
zombie 	zombie 
decomposition	décomposition
pongal 	pongal
myogenesis	myogenèse
rhinoplasty	rhinoplastie
dextroamphetamine	dextroamphétamine
trachea	trachée
nootropic	nootrope
detonation	détonation
hyperprolactinaemia	hyperprolactinémie
gamma-glutamyltransferase	gamma-glutamyltranspeptidase
pulse	pouls
dhaka	dacca
ayurveda	ayurveda
agonist	agoniste 
gastroenterology	gastro-entérologie
mebeverine	mébévérine
interpol	interpol
ischemia	ischémie
hepatectomy	hépatectomie
food	nourriture
benzazepine	benzoazépine
cadherin	cadhérine
saliva	salive
syncope 	syncope 
vemurafenib	vemurafenib
rotenone	roténone
catecholamine	catécholamine
catharanthus	catharanthus
mercury 	mercure 
2c-t-2	2c-t-2
nesiritide	nésiritide
soma 	péricaryon
poison	poison
tachycardia	tachycardie
watt	watt
yajnavalkya	yājñavalkya
ageusia	agueusie
sensitization	potentialisation
dietitian	diététicien
ischemia	ischémie
autopsy	autopsie
triathlon	triathlon
atherectomy	athérectomie
imepitoin	imépitoïne
stolon	stolon 
pubmed	pubmed
obesity	obésité
angiotensin	angiotensine
socrates	socrate
picatrix	picatrix
systole	systole
hydralazine	hydralazine
enantiomer	énantiomérie
gametogenesis	gamétogenèse
clamp 	serre-joint
gym	gymnase 
lager	lager
ultrafiltration	ultrafiltration
platonism	platonisme 
light	lumière
microorganism	micro-organisme
neuropeptide	neuropeptide
methionine	méthionine
mumbai	bombay
canterbury	canterbury
watsu	watsu
ileostomy	iléostomie
divination	divination
peptide	peptide
anthracene	anthracène
librivox	librivox
naringenin	naringinine
catharanthus	catharanthus
polyuria	polyurie
anethole	anéthol
cheek	joue
coelom	cœlome
tirtha 	tirthadana
anthelmintic	anthelminthique
tretinoin	trétinoïne
parent	parent 
tamoxifen	tamoxifène
androstenediol	5-androstènediol
radiography	radiographie
ounce	once 
ammonium	ammonium
erythromycin	érythromycine
etilefrine	étiléfrine
krupnik	krupnik
thrombosis	thrombose
transducin	transducine
ivacaftor	ivacaftor
scleroderma	sclérodermie
vacutainer	vacutainer
koinon	koinon
parasitism	parasitisme
diploblasty	diploblastique
tiagabine	tiagabine
gastroenteritis	gastro-entérite
taste	goût
androstane	androstane
yohimbine	yohimbine
ascites	ascite
occult 	occultation 
medtronic	medtronic
sonoluminescence	sonoluminescence
bilirubin	bilirubine
cadaver	cadavre
pneumonectomy	pneumonectomie
cyclodextrin	cyclodextrine
family 	famille 
tubulin	tubuline
progesterone	progestérone
gamma-glutamyltransferase	gamma-glutamyltranspeptidase
amoxicillin	amoxicilline
seed	graine
avidin	avidine
metatarsalgia	métatarsalgie
yttrium	yttrium
pharynx	pharynx
foreskin	prépuce
catechol	pyrocatéchol
cyclizine	cyclizine
glucose	glucose
angiosarcoma	angiosarcome
lycurgus 	lycurgue 
nicotine	nicotine
betamethasone	bétaméthasone
vienna	vienne 
electrocardiography	électrocardiographie
methylprednisolone	méthylprednisolone
teratology	tératologie
nocturia	nycturie
paresthesia	paresthésie
iris 	iris 
hyperphosphatemia	hyperphosphorémie
medusa	méduse 
furin	furine
fabomotizole	fabomotizole
cancer	cancer
cell 	cellule 
urbanization	urbanisation
hydrogel	hydrogel
esophagus	œsophage
medea	médée 
thiol	thiol
transferase	transférase
seaborgium	seaborgium
protactinium	protactinium
pandemic	pandémie
gene	gène
al-tasrif	al-tasrif
verbosity	verbiage
aorta	aorte
valence 	valence 
sertraline	sertraline
masitinib	masitinib
acupuncture	acupuncture
arteritis	artérite
algorithm	algorithme
alcoholism	alcoolisme
anisakis	anisakis
nature 	nature 
immunodeficiency	immunodéficience
anticoagulant	anticoagulant
angioma	angiome
ketamine	kétamine
paprika	paprika
palpation	palpation 
jwh-018	jwh-018
spring 	source 
plumbing	plomberie
ultrasound	ultrason
square 	carré 
ethenzamide	éthenzamide
affix	affixe
abca1	abca1
thymoquinone	thymoquinone
lumiliximab	lumiliximab
metaplasia	métaplasie
morphea	morphée 
ion	ion
trachea	trachée
sparta	sparte
pneumoperitoneum	pneumopéritoine
massage	massage
opiate	opiacé
romiplostim	romiplostim
lacidipine	lacidipine
photosynthesis	photosynthèse
rabbit	lapin
puruṣārtha	purushartha
acoustics	acoustique
pericarditis	péricardite
thoracotomy	thoracotomie
ciclopirox	ciclopirox
photography	photographie
bear	ursidae
myh7	myh7
gundeshapur	gundishapur
emtricitabine	emtricitabine
homelessness	sans-abri
isozyme	isoenzyme
prebiotic 	prébiotique
polyphagia	polyphagie 
calorie	calorie
gamma-glutamyltransferase	gamma-glutamyltranspeptidase
condom	préservatif
peritonitis	péritonite
crematorium	crématorium
hospital	hôpital
sedative	sédatif
pyknosis	pycnose
qiyan	qiyan
hyperthyroidism	hyperthyroïdie
ertugliflozin	ertugliflozine
cyprus	chypre 
caveolin	cavéoline
archimedes	archimède
exoplanet	exoplanète
soul	âme
tyramine	tyramine
overdiagnosis	surdiagnostic
actinopterygii	actinopterygii
religion	religion
avocado	avocatier
cyclophosphamide	cyclophosphamide
cocaine	cocaïne
caesium	césium
1,1,1-trichloroethane	1,1,1-trichloroéthane
blue	bleu
cryonics	cryonie
tofacitinib	tofacitinib
melanocyte	mélanocyte
tracheotomy	trachéotomie
auriculotherapy	auriculothérapie
tetanospasmin	tétanospasmine
mesenchyme	mésenchyme
cement	ciment
bodybuilding	culturisme
plasmapheresis	plasmaphérèse
feminization 	féminisation 
vps33b	vps33b
triadin	triadine
risankizumab	risankizumab
seroconversion	séroconversion
conservatorship	tutelle
decontamination	décontamination
vaidya	vaidya
acromegaly	acromégalie
tears	larme
sars-cov-2	sars-cov-2
creb	creb 
necromancy	nécromancie
dysbindin	dysbindine
tretinoin	trétinoïne
apnea	apnée
puranas	purana
apulia	pouilles
picatrix	picatrix
thailand	thaïlande
connexon	connexon
piroxicam	piroxicam
electrocardiography	électrocardiographie
photon	photon
diploë	diploé
oviparity	oviparité
petalite	pétalite
propan-1-ol	propan-1-ol
streptococcus	streptocoque
sense	sens 
cardiomegaly	cardiomégalie
survey 	sondage 
cheongju 	cheongju 
achlorhydria	achlorhydrie
chiropractic	chiropratique
ludgate	ludgate
islam	islam
kanji	kanji
mucus	mucus
pregabalin	prégabaline
emaciation	émaciation
isagoge	isagogè
mantidae	mantidae
selumetinib	selumetinib
billion	billion 
genus	genre 
snorkeling	snorkeling
marination	marinade
acamprosate	acamprosate
konye-urgench	kounia-ourguentch
4-acetoxy-dipt	4-aco-dipt
menadione	ménadione
cyst	kyste 
nocturnality	nocturne 
mitochondrion	mitochondrie
vertebra	vertèbre
dipropyltryptamine	dipropyltryptamine
elbow	coude
brahman	brahman
nocturia	nycturie
hypoxemia	hypoxémie
diplopia	diplopie
heart	cœur
prolactin	prolactine
university	université
dryness 	sec 
pipotiazine	pipotiazine
cricothyrotomy	cricothyroïdotomie
telethonin	téléthonine
nanotechnology	nanotechnologie
elastography	élastographie
s-nitroso-n-acetylpenicillamine	s-nitroso-n-acétylpénicillamine
hemichordate	hemichordata
pericyte	péricyte
rama	rāma
kaempferol	kaempférol
europe	europe
metabolism	métabolisme
prayer	prière
acta2	acta2
s-nitrosothiol	s-nitrosothiol
livermorium	livermorium
terlipressin	terlipressine
lithium	lithium
amifampridine	amifampridine
androsterone	androstérone
n,n-dimethyltryptamine	diméthyltryptamine
colchicine	colchicine
hyperprolactinaemia	hyperprolactinémie
geisha	geisha
circumscription 	circonscription 
afatinib	afatinib
taurine	taurine
sattriya	sattriya
sanskrit	sanskrit
bilirubin	bilirubine
lung	poumon
drowning	noyade
austria	autriche
deletion 	délétion
marsupial	marsupialia
kansas	kansas
psoriasis	psoriasis
cocaine	cocaïne
velcro	velcro
chromophore	chromophore
cymarin	cymarine
digitalis	digitale
acetanilide	acétanilide
precursor 	précurseur 
bifonazole	bifonazole
monogamy	monogamie
neostigmine	néostigmine
caricature	caricature
cambodia	cambodge
slag	scorie 
mdma	mdma
disability	handicap
microalbuminuria	microalbuminurie
amgen	amgen
medicare 	medicare
catenation	caténation
fraud	fraude
neurology	neurologie
tetraethylammonium	tétraéthylammonium
altitude	altitude
entomophagy	entomophagie
vulgate	vulgate
magnetoencephalography	magnétoencéphalographie
maprotiline	maprotiline
brass	laiton
sharia	charia
glycosaminoglycan	glycosaminoglycane
bronchiole	bronchiole
carbanion	carbanion
catarrh	catarrhe
genotype	génotype
deicing	dégivrage 
nematode	nematoda
pentraxins	pentraxine
amylase	amylase
electronvolt	électronvolt
bradycardia	bradycardie
moisture	humidité
cryptography	cryptographie
bran	son 
aconitum	aconitum
colombia 	colombia 
corticosteroid	corticoïde
synonym	synonyme
kronan 	kronan
viviparity	viviparité
medicine	médecine
denaturation 	dénaturation
pramipexole	pramipexole
vivisection	vivisection
hypoxia 	hypoxie
hospital	hôpital
microangiopathy	microangiopathie
neighbourhood	quartier 
württemberg	wurtemberg
eukaryote	eukaryota
lead	plomb
diglyceride	diglycéride
heracles	héraclès
vasoconstriction	vasoconstriction
nystagmus	nystagmus
obstetrics	obstétrique
oxipurinol	oxypurinol
bendiocarb	bendiocarbe
interferon	interféron
sociology	sociologie
infrared	infrarouge
bologna	bologne
hydantoin	hydantoïne
dextran	dextrane
axitinib	axitinib
pseudo-geber	pseudo-geber
baghdad	bagdad
suda	souda
metopimazine	métopimazine
bank	banque
artemis	artémis
cirrhosis	cirrhose
endothelium	endothélium
cefazolin	céfazoline
coronavirus	coronavirus
light	lumière
enterolactone	entérolactone
cryonics	cryonie
echocardiography	échocardiographie
anxiety	anxiété
giardiasis	giardiase
kurds	kurdes
desalination	dessalement
stegosaurus	stegosaurus
choline	choline
heparinoid	héparinoïde
vasodilation	vasodilatateur
paradigm	paradigme
colubrinae	colubrinae
serum 	sérum
shasekishū	shasekishū
bleeding	hémorragie
xanthopsia	xanthopsie
optometry	optométrie
lurasidone	lurasidone
mesopotamia	mésopotamie
potassium	potassium
sauna	sauna
virology	virologie
togo	togo
fungus	fungi
yoga	yoga
cochrane 	cochrane 
lung	poumon
bisexuality	bisexualité
endurance	endurance
promession	promession
divergence 	divergence 
aminopterin	aminoptérine
ham	jambon
humerus	humérus
telethonin	téléthonine
fomite	fomite
brahmana	brahmana
hypoxia 	hypoxie
gin	gin
haecceity	eccéité
melanosome	mélanosome
music	musique
cerebrum	télencéphale
sting 	sting
biomarker	biomarqueur
psychiatrist	psychiatre
martyr	martyr
hematocrit	hématocrite
rutin	rutoside
piezoelectricity	piézoélectricité
equol	equol
bloodletting	saignée 
vandalism	vandalisme
anthropology	anthropologie
norvaline	norvaline
prokaryote	prokaryota
transmittance	transmittance
mollicutes	mollicutes
chloralose	chloralose
ophthalmology	ophtalmologie
epilepsy	épilepsie
fibrosis	fibrose
erasmus+	erasmus+
hyponatremia	hyponatrémie
lymphangitis	lymphangite
ionization	ionisation
nitrox	nitrox
transduction 	transduction 
theanine	théanine
triglyceride	triglycéride
sepal	sépale
villach	villach
antiserum	sérothérapie
pindolol	pindolol
parmenides	parménide
amblygonite	amblygonite
rhinoceros	rhinocéros
trimecaine	trimécaïne
mahābhūta	bhuta
paracetamol	paracétamol
swaminarayan	swaminarayan
polyphyly	polyphylie
starch	amidon
lung	poumon
axilla	aisselle
hippie	hippie
glycoside	hétéroside
childbirth	accouchement
mepolizumab	mepolizumab
henry 	henry 
glottis	glotte
therapy	traitement 
pentoxifylline	pentoxifylline
antimicrobial	antimicrobien
dressing 	mèche 
dynamin	dynamine 
ambiguity	ambiguïté
electrocardiography	électrocardiographie
cyclooxygenase	cyclooxygénase
kroger	kroger
filgotinib	filgotinib
cpr-1000	cpr-1000
ilium 	ilium 
nepal	népal
agave	agave
clinician	clinicien
vismodegib	vismodégib
mimnermus	mimnerme
temperament	tempérament 
folliculitis	folliculite
angiotensin	angiotensine
isozyme	isoenzyme
sacrifice	sacrifice
sacrum	sacrum
logic	logique
perindopril	périndopril
palonosetron	palonosétron
boldo	boldo
ethinylestradiol	éthinylestradiol
ekg 	ekg
roche	roche 
pork	porc 
antacid	antiacide
thymosin	thymosine
epiglottis	épiglotte
levocetirizine	lévocétirizine
neuroblastoma	neuroblastome
xerostomia	xérostomie
pompeii	pompéi
parathyroidectomy	parathyroïdectomie
whey	lactosérum
coagulopathy	coagulopathie
thujone	thuyone
phronesis	phronesis
lumen 	lumière 
ketoconazole	kétoconazole
metapontum	métaponte
tajikistan	tadjikistan
baicalein	baicaléine
indigestion	dyspepsie
wound	plaie
natalizumab	natalizumab
fatigue	fatigue 
erlotinib	erlotinib
medicine	médecine
saxitoxin	saxitoxine
allodynia	allodynie
pumsavana	pumsavana
furosemide	furosémide
glucosamine	glucosamine
amide	amide
probability	probabilité
olanzapine	olanzapine
cardiomegaly	cardiomégalie
obesity	obésité
trout	truite
statin	statine
inotrope	inotropisme
interstitium	interstitium
lydd	lydd
sparteine	spartéine
autobiography	autobiographie
antiarin	antiarine
bust 	buste 
chancellor 	chancelier 
dräger 	drägerwerk
exosome 	exosome 
drill	perceuse
genogram	génogramme
correlation	corrélation 
phosphocholine	phosphocholine
uterus	utérus
fukuryu	fukuryū
zpp 	zpp 
mucin	mucine
sulfanilamide	sulfanilamide
pollution	pollution
kampala	kampala
baculum	baculum
eurasia	eurasie
ear	oreille
riboflavin	riboflavine
athena	athéna
beta-lactoglobulin	bêta-lactoglobuline
feni 	fenny
epimer	épimère
routledge	routledge
allotropy	allotropie
plastination	plastination
antispasmodic	antispasmodique
sneeze	éternuement
rosicrucianism	rose-croix
8-hydroxyquinoline	8-hydroxyquinoléine
dicaearchus	dicéarque
jiaolong 	jiaolong
interpreter 	interprète 
utrecht	utrecht
hamadan	hamadan
medication	médicament
helorus	heloros
karyorrhexis	caryorrhexie
antidiuretic	antidiurétique
pre-eclampsia	pré-éclampsie
kif15	kif15
phenols	phénol 
electrolyte	électrolyte
dentition	denture
pnictogen	pnictogène
fluticasone/salmeterol	sérétide
paronychia	panaris
coprophagia	coprophagie
amineptine	amineptine
linuron	linuron
spherocytosis	sphérocytose
mepacrine	quinacrine
para-methoxyamphetamine	paraméthoxyamphétamine
laxative	laxatif
nordazepam	nordazépam
al-kindi	al-kindi
polysomnography	polysomnographie
provost 	provost 
sumac	rhus
tautomer	tautomère
vertebra	vertèbre
ministry 	ministère 
archosaur	archosauria
vasoconstriction	vasoconstriction
tetrodotoxin	tétrodotoxine
anaspidea	anaspidea
desmin	desmine
hepatotoxicity	hépatotoxicité
homeostasis	homéostasie
clearance 	clairance 
aligarh	aligarh
panchadasi	panchadashi
cytochrome	cytochrome
haloperidol	halopéridol
lead	plomb
artery	artère
marl	marne 
purpura	purpura
angiotensin	angiotensine
menarche	ménarche
adapalene	adapalène
serology	sérologie
vertebra	vertèbre
leucippus	leucippe
mastitis	mammite
sommelier	sommelier
rize	rize
homophobia	homophobie
tic	tic
rasagiline	rasagiline
methyllithium	méthyllithium
phenindione	phénindione
spain	espagne
frog	anoures
genome	génome
hospice	hospice
scutellaria	scutellaria
osteocalcin	ostéocalcine
fertilizer	engrais
statin	statine
coloureds	coloured
daclizumab	daclizumab
smartwatch	smartwatch
neoplasm	néoplasie
chlorproethazine	chlorproéthazine
pubmed	pubmed
infection	infection
hospice	hospice
dexter 	dexter 
ketorolac	kétorolac
transudate	transsudat
methacholine	méthacholine
chickenpox	varicelle
valine	valine
highball	highball 
saturn 	saturne 
rosicrucianism	rose-croix
endosulfan	endosulfan
atharvaveda	atharva-véda
eclampsia	éclampsie
fatigue	fatigue 
radiography	radiographie
carbonate	carbonate
polywell	polywell
vegetarianism	végétarisme
ergine	ergine
polonium	polonium
mifepristone	mifépristone
duloxetine	duloxétine
oxiracetam	oxiracétam
pubchem	pubchem
eukaryote	eukaryota
arecoline	arécoline
palestine 	palestine 
mobula	mobula
singani	singani 
pyknosis	pycnose
acetylcholinesterase	acétylcholinestérase
sphincter	sphincter
denervation	dénervation
pregnancy	grossesse
kif24	kif24
sugar	sucre
virulence	virulence
granuloma	granulome
lentini	lentini
tachypnea	tachypnée
chlorhexidine	chlorhexidine
poppers	poppers
guanfacine	guanfacine
antiferromagnetism	antiferromagnétisme
guanine	guanine
propyne	propyne
medication	médicament
evidence	preuve
slamf7	slamf7
dogma	dogme
aristoxenus	aristoxène
disease	maladie
stridor	stridor
pharmacopoeia	pharmacopée
aristotelianism	aristotélisme
cardiology	cardiologie
astrazeneca	astrazeneca
artemisinin	artémisinine
pittsburgh	pittsburgh
minoxidil	minoxidil
adventitia	adventice 
textile	textile
barotrauma	barotraumatisme
5-it	5-indole
cladribine	cladribine
curaçao 	curaçao 
haptoglobin	haptoglobine
diuretic	diurétique
ischemia	ischémie
calorie	calorie
myofibroblast	myofibroblaste
patisiran	patisiran
dihydromorphine	dihydromorphine
gentamicin	gentamicine
trabectedin	trabectédine
amphetamine	amphétamine
assignment 	affectation 
moment 	moment 
neolithic	néolithique
mianserin	miansérine
mollusca	mollusca
edema	œdème
iatrochemistry	iatrochimie
motilin	motiline
fluphenazine	fluphénazine
brachytherapy	curiethérapie
aliskiren	aliskirène
paracelsus	paracelse
sirukumab	sirukumab
decompensation	décompensation
immunodeficiency	immunodéficience
camagüey	camagüey
masterpiece	chef-d'œuvre
bulb	bulbe
depressant	dépresseur
emotion	émotion
pharmacovigilance	pharmacovigilance
vaishnavism	vishnouisme
surya	sūrya
solvent	solvant
vertebra	vertèbre
solution 	solution 
miami	miami
hydrocortisone	hydrocortisone
exercise	fitness
berlin	berlin
remscheid	remscheid
capillary	capillaire 
uniprot	uniprot
paleopathology	paléopathologie
pump	pompe
wikisource	wikisource
metalloproteinase	métalloprotéinase
extravasation	extravasation
ehrlichiosis	ehrlichiose
tachycardia	tachycardie
karoshi	karōshi
enteritis	entérite
integrase	intégrase
terumo	terumo
logotherapy	logothérapie
tavern	taverne 
cyclopropenylidene	cyclopropénylidène
uterus	utérus
papaver	pavot
halogen	halogène
cd20	cd20
parasitism	parasitisme
allylglycine	allylglycine
demosthenes	démosthène
fluorouracil	fluorouracile
diphenhydramine	diphénhydramine
kiss	baiser
avicenna	avicenne
marinejegerkommandoen	marinejegerkommandoen
heme	hème
drag 	traînée
hindus	hindous
2,5-dimethoxy-4-methylamphetamine	2,5-diméthoxy-4-méthylamphétamine
dientamoebiasis	dientamœbose
nutrient	nutriment
anemophily	anémophilie
hydronephrosis	hydronéphrose
1,1,1-trichloroethane	1,1,1-trichloroéthane
fungus	fungi
trofosfamide	trofosfamide
ethanol	éthanol
kilogram	kilogramme
nitrile	nitrile
bronchus	bronche
alosetron	alosétron
immunofluorescence	immunofluorescence
knee	genou
diosmetin	diosmétine
ganglioside	ganglioside
ginkgolide	ginkgolide
combinatorics	combinatoire
pfam	pfam
hemocyanin	hémocyanine
hypothyroidism	hypothyroïdie
doxorubicin	doxorubicine
hemangiopericytoma	hémangiopéricytome
atrazine	atrazine
coffeehouse	café 
hydrotherapy	hydrothérapie
java	java 
philippines	philippines
atropisomer	atropoisomère
thrombosis	thrombose
overtone	partiel 
gamma-glutamyltransferase	gamma-glutamyltranspeptidase
1,000,000,000	milliard
chemoprophylaxis	chimioprévention
psychopathology	psychopathologie
sociology	sociologie
pneumostome	pneumostome
gossypetin	gossypétine
tropisetron	tropisétron
pemphigus	pemphigus
cannula	canule
quakers	quaker
yorkshire	yorkshire
diazenylium	diazénylium
ataxia	ataxie
rumen	panse
nelfinavir	nelfinavir
bronchodilator	bronchodilatateur
leucine	leucine
atovaquone	atovaquone
atrium 	atrium 
lumiliximab	lumiliximab
patient	patient
cardioversion	cardioversion
ohm	ohm 
cytotoxicity	cytotoxicité
pimavanserin	pimavansérine
bradycardia	bradycardie
commander 	commandeur
insulinoma	nésidioblastome
weakness	asthénie
kifc3	kifc3
eurocentrism	eurocentrisme
mycobacterium	mycobacterium
game 	gibier
sacrum	sacrum
chamomile	camomille
perspiration	sueur
pericardium	péricarde
anti-inflammatory	anti-inflammatoire
interhalogen	interhalogène
négritude	négritude
rivaroxaban	rivaroxaban
benzopyrene	benzopyrène
trpm8	trpm8
atosiban	atosiban
paracrystallinity	paracristal
clove	giroflier
quartile	quartile
scalpel	bistouri
adamantane	adamantane
prostaglandin	prostaglandine
atresia	atrésie
whisky	whisky
actuary	actuaire
ibex	bouquetin
inflammation	inflammation
aorta	aorte
neurotoxicity	neurotoxicité
humanities	lettres 
advocaat	advocaat
contraindication	contre-indication
methylphenidate	méthylphénidate
vertebra	vertèbre
behaviorism	béhaviorisme
litharge	litharge
language	langage
natron	natron
dräger 	drägerwerk
peroxidase	peroxydase
brazil	brésil
uremia	urémie
osmolyte	osmolyte
eplerenone	éplérénone
analgesic	antalgique
trachea	trachée
fossil	fossile
bilirubin	bilirubine
hippocrates	hippocrate
thioamide	thioamide
keratosis	kératose
rilonacept	rilonacept
roehampton	roehampton
antipsychotic	neuroleptique
anisocytosis	anisocytose
telenzepine	télenzépine
osteochondrosis	ostéochondrite
blood	sang
lignan	lignane
neper	néper
lorcaserin	lorcasérine
hermetica	hermetica
electrocardiography	électrocardiographie
chalcogen	chalcogène
poodle	caniche
alpha-2-macroglobulin	alpha-2-macroglobuline
asepsis	asepsie
pharynx	pharynx
slamf7	slamf7
capsaicin	capsaïcine
alpha-mannosidosis	alpha-mannosidose
transport	transport
bhakti	bhakti
hyperhidrosis	hyperhidrose
hemoglobin	hémoglobine
terazosin	térazosine
dimercaprol	dimercaprol
arginine	arginine
curcumin	curcumine
bone	os
belatacept	bélatacept
liquorice	réglisse
hemopexin	hémopexine
cambridge	cambridge
infant	nourrisson
rationalism	rationalisme
halophyte	halophyte
viscosity	viscosité
jund	jund
lying 	décubitus
eschatology	eschatologie
pregnenolone	prégnénolone
primate	primates
motto	devise 
impulsivity	impulsivité
transcortin	transcortine
tolvaptan	tolvaptan
intention	intention
equivalent 	équivalent 
cough	toux
1-butanol	butan-1-ol
hypoxemia	hypoxémie
eurotransplant	eurotransplant
microscope	microscope
tentacle	tentacule
3,4-methylenedioxyamphetamine	3,4-méthylènedioxyamphétamine
ziryab	ziriab
lip	lèvre
epidermis	épiderme 
antihistamine	antihistaminique
probiotic	probiotique
18-methoxycoronaridine	18-methoxycoronaridine
homocysteine	homocystéine
wound	plaie
retinoid	rétinoïde
ivabradine	ivabradine
anode	anode
heart	cœur
dracula 	dracula 
coumatetralyl	coumatétralyle
digitoxin	digitoxine
physiology	physiologie
cabazitaxel	cabazitaxel
eudaimonia	eudaimonia
lobotomy	lobotomie
methamphetamine	méthamphétamine
medicine	médecine
fludiazepam	fludiazépam
aphrodisiac	aphrodisiaque
senegal	sénégal
carbohydrate	glucide
sumer	sumer
anatolia	anatolie
biofilm	biofilm
endothelin	endothéline
carnivora	carnivora
pneumocephalus	pneumocéphale
acetylation	acétylation
judo	judo
scurvy	scorbut
eosinophilia	éosinophilie
nail 	ongle
mitosis	mitose
reimbursement	remboursement
triclosan	triclosan
sponge	porifera
medicine	médecine
eptifibatide	eptifibatide
catheter	cathéter
tabun 	tabun
crackles	crépitant
keratolytic	kératolytique
flumazenil	flumazénil
therapy	traitement 
inotrope	inotropisme
hyperammonemia	hyperammoniémie
sorbitol	sorbitol
behavior	comportement
toxin	toxine
hemagglutinin	hémagglutinine
photosensitivity	photosensibilité
ddt	dichlorodiphényltrichloroéthane
understanding	compréhension
isoleucine	isoleucine
cerussite	cérusite
trypanosomiasis	trypanosomiase
thanatosensitivity	thanatosensitivité
glycogen	glycogène
nicorandil	nicorandil
madrasa	médersa
dénia	dénia
psychiatry	psychiatrie
vertebra	vertèbre
adenosylcobalamin	adénosylcobalamine
thymosin	thymosine
bleeding	hémorragie
purpura	purpura
grain	grain 
oleuropein	oleuropéine
mizolastine	mizolastine
urination	miction
stigmine	stigmine
museum	musée
amsonia	amsonia
avicenna	avicenne
gonadotropin	gonadotrophine
notary	notaire
autosome	autosome
francium	francium
paraquat	paraquat
vertebrate	vertébrés
mycoplasmataceae	mycoplasmataceae
al-asmaʿi	al-asmai
calcitriol	calcitriol
2,5-dimethoxy-4-bromoamphetamine	2,5-diméthoxy-4-bromoamphétamine
intuition	intuition
ritonavir	ritonavir
chlortalidone	chlortalidone
shandy	panaché
endocardium	endocarde
vomiting	vomissement
drama	drame 
velia	élée
ceritinib	ceritinib
paint	peinture 
thought	pensée
lung	poumon
contraindication	contre-indication
clover	trèfle
calvados	calvados 
hemofiltration	hémofiltration
binder 	liant
chemotherapy	chimiothérapie
anticholinergic	anticholinergique
strophanthin	strophanthine
amiodarone	amiodarone
chromium	chrome
calorimetry	calorimétrie
invertebrate	invertébré
metastasis	métastase 
canning	conserve
quetiapine	quétiapine
cytokine	cytokine
pear	pyrus
chancre	ulcération
daratumumab	daratumumab
salbutamol	salbutamol
irinotecan	irinotécan
mysticism	mystique
nucleotide	nucléotide
trachea	trachée
mediastinoscopy	médiastinoscopie
dapoxetine	dapoxétine
navaratri	navratri
pesto	pesto
horseradish	raifort
bilastine	bilastine
zuclopenthixol	zuclopenthixol
prognosis	pronostic 
electrolyte	électrolyte
cetuximab	cétuximab
hemopericardium	hémopéricarde
injury	traumatisme 
urokinase	urokinase
iquique	iquique
eucryptite	eucryptite
shichimi	shichimi
leukopenia	leucopénie
anticoagulant	anticoagulant
lung	poumon
ageing	vieillissement
shepseskaf-ankh	chepseskaf-ânkh
fatsa	fatsa
diethylcarbamazine	diéthylcarbamazine
sarissa	sarisse
perphenazine	perphénazine
furosemide	furosémide
valdecoxib	valdécoxib
levitation 	lévitation 
liquorice	réglisse
cannabinoid	cannabinoïde
cirrhosis	cirrhose
aziridine	aziridine
holi	holi
anencephaly	anencéphalie
hemiparesis	hémiparésie
digestion	digestion
electrooculography	électrooculographie
angiography	angiographie
positivism	positivisme
malaria	paludisme
monofin	monopalme
cobalt	cobalt
pi 	pi 
vodka	vodka
behavior	comportement
myosin	myosine
levobunolol	lévobunolol
kinase	kinase
electrostatics	électrostatique
neurofilament	neurofilament
carmustine	carmustine
scar	cicatrice
bihu	bihu
shampoo	shampooing
tooth	dent
memory	mémoire 
morphology 	morphologie 
medicine	médecine
focusing 	focusing
daunorubicin	daunorubicine
triazolam	triazolam
ash'ari	acharisme
methamphetamine	méthamphétamine
hypnotic	hypnotique
ammonia	ammoniac
al-nasa'i	an-nasa'i
solubility	solubilité
pyrococcus	pyrococcus
cd19	cd19
tmem43	tmem43
zuclopenthixol	zuclopenthixol
antianginal	antiangoreux
oregano	origan
antidepressant	antidépresseur
uridine	uridine
athetosis	athétose
alberta	alberta
gaudapada	gaudapada
appetite	appétit
bee	abeille
orosomucoid	orosomucoïde
vishvakarma	vishvakarma
histopathology	histopathologie
exercise	fitness
pinocembrin	pinocembrine
hyperkeratosis	hyperkératose
parasitemia	parasitémie
ticlopidine	ticlopidine
ramlila	ramlila
attention	attention
mineral	minéral
schizophrenia	schizophrénie
methylphenidate	méthylphénidate
serology	sérologie
laughter	rire
eurobarometer	eurobaromètre
lymphocytosis	hyperlymphocytose
buflomedil	buflomédil
self-medication	automédication
bronchus	bronche
lymphangioleiomyomatosis	lymphangioléiomyomatose
oxazepam	oxazépam
chlamydia	chlamydiose
ordu	altınordu
diastole	diastole
bon	bön
1,10-phenanthroline	1,10-phénanthroline
phenylalanine	phénylalanine
hydrostatics	hydrostatique
lipophilicity	lipophilie
anxiolytic	anxiolytique
haridwar	haridwar
parasitism	parasitisme
oxidoreductase	oxydoréductase
ganesha	ganesh
bilateria	bilateria
electrocardiography	électrocardiographie
therapy	traitement 
isavuconazonium	isavuconazole
2-oleoylglycerol	2-oléylglycérol
syndemic	syndémie
spirometer	spiromètre
cataract	cataracte 
rhodamine	rhodamine
fibronectin	fibronectine
inequality 	inégalité 
lanthanide	lanthanide
brindisi	brindisi
ophthalmology	ophtalmologie
wheat	blé
wuhan	wuhan
stellarator	stellarator
history	histoire
antimony	antimoine
acid	acide
bivalirudin	bivalirudine
annelid	annelida
stotra	stotra
dysentery	dysenterie
land 	terre 
vein	veine
specials 	ufff0
aneurysm	anévrisme
magnetostriction	magnétostriction
nutrien	nutrien
saquinavir	saquinavir
quinoline	quinoléine
microcytosis	microcytose
tetanus	tétanos
hallucination	hallucination
hydrostatics	hydrostatique
erasmus	érasme
saskatchewan	saskatchewan
oxymorphone	oxymorphone
laparotomy	laparotomie
glycitein	glycitéine
antipsychotic	neuroleptique
cephalopod	céphalopode
rosids	rosidées
tetrandrine	tétrandrine
asepsis	asepsie
yakitori	yakitori
paracetamol	paracétamol
cod	morue
cauterization	cautérisation
delusion	délire
atrium 	atrium 
boeotia	béotie
exanthem	exanthème
atrium 	atrium 
taxifolin	taxifoline
codeine	codéine
lithiophilite	lithiophilite
6-apb	6-benzofurane
clinic	clinique
nelarabine	nélarabine
esmirtazapine	esmirtazapine
capsule 	capsule 
brca2	brca2
ultraviolet	ultraviolet
cartography	cartographie
shingles	zona
thalidomide	thalidomide
bronchitis	bronchite
phosphate	phosphate
benzocaine	benzocaïne
resonance	résonance
padua	padoue
ayurveda	ayurveda
otorhinolaryngology	otorhinolaryngologie
alfentanil	alfentanil
memantine	mémantine
transudate	transsudat
pub	pub 
heart	cœur
potassium	potassium
slug	limace
aquifer	aquifère
himbeergeist	himbeergeist
samhita	samhita
presenteeism	présentéisme
hohenheim	hohenheim 
infection	infection
xyloglucan	xyloglucane
hepatomegaly	hépatomégalie
mitogen	mitogène
alkali	alcali
ecology	écologie
stain	tache
hemodynamics	hémodynamique
barium	baryum
phenmetrazine	phenmétrazine
arachnid	arachnida
pre-adamite	préadamisme
phanagoria	phanagoria
fipronil	fipronil
stereotypy	stéréotypie 
thermogenesis	thermogenèse
kickback 	rétrocommission
poetics 	poétique 
solicitor	solliciteur
ribose	ribose
chop 	chop 
arylcyclohexylamine	arylcyclohexylamine
mathematics	mathématiques
cortisone	cortisone
leaf	feuille
therapy	traitement 
inflammation	inflammation
mdma	mdma
genereviews	genereviews
pathology	pathologie
monomethylhydrazine	méthylhydrazine
wood	bois
stata	stata
filicudi	filicudi
encephalopathy	encéphalopathie
vishu	vishu
nobelium	nobélium
plumbing	plomberie
bezafibrate	bézafibrate
carcinoma	carcinome
neglect	négligence 
hepatoblastoma	hépatoblastome
diuresis	diurèse
tert-butyllithium	tert-butyllithium
asthma	asthme
phylogenetics	phylogénie
oxybutynin	oxybutynine
peptide	peptide
butyrylcholinesterase	butyrylcholinestérase
asia	asie
kartikeya	kârttikeya
hydrogen	hydrogène
rainbow	arc-en-ciel
alcohol 	alcool 
meloxicam	méloxicam
hypovolemia	hypovolémie
fatigue	fatigue 
kent	kent
basiluzzo	basiluzzo
clevidipine	clévidipine
snoring	ronflement
astereognosis	astéréognosie
hyperlipidemia	hyperlipémie
oricum	oricum
rimantadine	rimantadine
racecadotril	racécadotril
dihydrotestosterone	androstanolone
submarine	sous-marin
inaturalist	inaturalist
troponin	troponine
mammal	mammifère
cholesterol	cholestérol
barotrauma	barotraumatisme
organomegaly	organomégalie
cryoglobulinemia	cryoglobulinémie
pandemic	pandémie
advocacy	plaidoyer 
tolbutamide	tolbutamide
conjunctiva	conjonctive
mediastinum	médiastin
supersaturation	sursaturation
skutterudite	skuttérudite
ouabain	ouabaïne
toxicity	toxicité
phenobarbital	phénobarbital
aromaticity	aromaticité
fludrocortisone	fludrocortisone
thermodynamics	thermodynamique
cerberus	cerbère
ketoprofen	kétoprofène
medlineplus	medlineplus
atrium 	atrium 
overtraining	surentraînement
plasmin	plasmine
welding	soudage
kinetoplast	kinétoplaste
almond	amandier
clomifene	clomifène
sensorium	sensorium
nirukta	nirukta
electrocardiography	électrocardiographie
hospital	hôpital
laüs	laos 
lesion	lésion 
refrigeration	réfrigération
gram	gramme
debye	debye 
electronegativity	électronégativité
thalamus	thalamus
cerebellum	cervelet
rhetoric 	rhétorique 
brine	saumure
taormina	taormine
budipine	budipine
citicoline	cytidine-diphosphate-choline
echocardiography	échocardiographie
propranolol	propranolol
defensin	défensine
pharmacotherapy	pharmacothérapie
lipocalin	lipocaline
glaucoma	glaucome
5-bromo-dmt	5-bromo-dmt
macaronesia	macaronésie
marjoram	marjolaine
chon	chnops
productivity	productivité
belimumab	belimumab
acronym	acronymie
dipsomania	dipsomanie
kyotorphin	kyotorphine
pasteurization	pasteurisation
vasishtha	vasishtha
retinoid	rétinoïde
amygdalin	amygdaline
sodium	sodium
ligand	ligand 
tyrosine	tyrosine
cinchona	cinchona
liqueur	liqueur
orthomyxoviridae	orthomyxoviridae
architecture	architecture
neuroanatomy	neuroanatomie
pisco	pisco
noscapine	noscapine
education	éducation
retrovirus	retroviridae
pramana	pramana
ovulation	ovulation
pharmacodynamics	pharmacodynamique
electromagnetism	électromagnétisme
subspecies	sous-espèce
contrast 	contraste
hydrogenation	hydrogénation
pentylenetetrazol	pentylènetétrazole
tiapride	tiapride
cephalohematoma	céphalhématome
decoction	décoction
mannitol	mannitol
echocardiography	échocardiographie
qazvin	qazvin
cannabis	cannabis
recursion	récursivité
aromatase	aromatase
vasopressin	vasopressine
antahkarana	antahkarana
sewerage	égout
sulcus 	sillon 
hypocalcemia	hypocalcémie
calculator	calculatrice
athlete	sportif
dermatitis	dermatite
pentamidine	pentamidine
titin	titine 
aldehyde	aldéhyde
willow	saule
skull	crâne
percussion 	percussion 
corynebacterium	corynebacterium
gerontology	gérontologie
tick	tique
scn1a	scn1a
asbestosis	asbestose
auscultation	auscultation
granite	granite
semarang	semarang
budesonide/formoterol	symbicort
lysophosphatidylcholine	lysophosphatidylcholine
clarithromycin	clarithromycine
lung	poumon
sarcomere	sarcomère
universe	univers
pathophysiology	physiopathologie
humidity	hygrométrie
nutrient	nutriment
microtubule	microtubule
monomer	monomère
dendrotoxin	dendrotoxine
thiamphenicol	thiamphénicol
demography	démographie
calcium	calcium
zolpidem	zolpidem
enteritis	entérite
stimulant	stimulant
allergy	allergie
polyelectrolyte	polyélectrolyte
quackery	charlatanisme
cancer	cancer
homeostasis	homéostasie
standardbred	standardbred
laryngitis	laryngite
work 	travail
enoximone	énoximone
therapy 	therapy
thiol	thiol
hypnotherapy	hypnothérapie
verapamil	vérapamil
mescaline	mescaline
infarction	infarctus
thiazepine	thiazépine
mass	masse
nerium	laurier-rose
felodipine	félodipine
mylan	mylan
dysosmia	dysosmie
aeolis	éolide
risk	risque
judeo-christian	judéo-chrétien
lepidolite	lépidolite
cardiology 	cardiology
mydriasis	mydriase
tryptamine	tryptamine
conscientiousness	conscienciosité
nauka 	nauka 
monochord	monocorde
folkestone	folkestone
apocynaceae	apocynaceae
laurium	lávrio
pericardium	péricarde
isoconazole	isoconazole
keshanta	keshanta
chudakarana	chudakarana
levocardia	lévocardie
superphénix	superphénix
bradycardia	bradycardie
optometry	optométrie
cannabinoid	cannabinoïde
acrylonitrile	acrylonitrile
bleeding	hémorragie
scrotum	scrotum
cyanoacetylene	cyanoéthyne
cardiomyopathy	cardiomyopathie
uganda	ouganda
myalgia	myalgie
maculopathy	maculopathie
facebook	facebook
valmiki	vâlmîki
cytoskeleton	cytosquelette
chemspider	chemspider
generation	génération 
agonist	agoniste 
phrenology	phrénologie
cauterization	cautérisation
trail	trail
actavis	actavis
mucus	mucus
asthma	asthme
blastocyst	blastocyste
lactoferrin	lactoferrine
forest	forêt
bioelectromagnetics	bioélectromagnétisme
arginase	arginase
caesar 	césar 
herpesviridae	herpesviridae
diatom	bacillariophyta
plitidepsin	plitidepsine
adenoviridae	adenoviridae
aerobics	aérobic
helium	hélium
dance	danse
mesothelioma	mésothéliome
containerization	conteneurisation
micafungin	micafungine
micrographia	micrographia
procaine	procaïne
arachnid	arachnida
neoplasm	néoplasie
dermatology	dermatologie
nabiximols	nabiximols
pseudohypoaldosteronism	pseudohypoaldostéronisme
salpingitis	salpingite
l-dopa	dopa
anticoagulant	anticoagulant
spermatid	spermatide
lymphadenopathy	adénopathie
epidermis	épiderme 
polytetrafluoroethylene	polytétrafluoroéthylène
α-carotene	alpha-carotène
sprain	entorse 
electrocardiography	électrocardiographie
hydrosilylation	hydrosilylation
cymbopogon	cymbopogon
conjunctivitis	conjonctivite
ubiquitin	ubiquitine
cumberland	cumberland 
turtle	tortue
juice	jus
spleen	rate
edema	œdème
crackles	crépitant
nectar	nectar 
thioester	thioester
propynylidyne	propynylidyne
palpitations	palpitation
clonidine	clonidine
disease	maladie
rembrandt	rembrandt
brachiopod	brachiopoda
organ 	organe
amygdalin	amygdaline
heuristic	heuristique
azelastine	azélastine
bromochlorodifluoromethane	bromochlorodifluorométhane
drink	boisson
babylonia	babylone 
praxiteles	praxitèle
medicine	médecine
ficlatuzumab	ficlatuzumab
pipamperone	pipampérone
chelation	chélation
atrium 	atrium 
econazole	éconazole
merit-ptah	méryt-ptah 
madhyamaka	madhyamaka
triboluminescence	triboluminescence
tachycardia	tachycardie
granuloma	granulome
lysis	lyse 
chloride	chlorure
lithotripsy	lithotripsie
kalam	kalâm
cardiomegaly	cardiomégalie
desmoglein-2	dsg2
chlorpromazine	chlorpromazine
protease	peptidase
siltuximab	siltuximab
daunorubicin	daunorubicine
phenylhydrazine	phénylhydrazine
dulaglutide	dulaglutide
carp	carpe 
biperiden	bipéridène
hertz	hertz
cough	toux
olaparib	olaparib
cyanosis	cyanose
rifampicin	rifampicine
vermouth	vermouth
ruminant	rumination 
prostacyclin	prostacycline
neurotransmitter	neurotransmetteur
laxative	laxatif
volleyball	volley-ball
rigveda	rig-véda
berbere	bérbéré
leiden	leyde
cinanserin	cinansérine
ocrelizumab	ocrélizumab
gynura	gynura
saltigue	saltigué
methylglyoxal	méthylglyoxal
bronchiolitis	bronchiolite
greece	grèce
bortezomib	bortézomib
thrombolysis	thrombolyse
indometacin	indométacine
2-arachidonoylglycerol	2-arachidonylglycérol
complication 	complication 
concentration	concentration 
sydney	sydney
argon	argon
dominance 	dominance 
acetylcholine	acétylcholine
glycolonitrile	glycolonitrile
picrotoxin	picrotoxine
dysmenorrhea	dysménorrhée
electronegativity	électronégativité
monocyte	monocyte
atherosclerosis	athérosclérose
trimix 	trimix
lung	poumon
anorectic	anorexigène
rubella	rubéole
immunoprecipitation	immunoprécipitation
aconitum	aconitum
spermatocyte	spermatocyte
tramadol	tramadol
spinel	spinelle
heredity	hérédité
lightning	foudre
tryptophan	tryptophane
deviance 	déviance
dosha	dosha
indometacin	indométacine
hemodialysis	hémodialyse
annelid	annelida
motility	motilité
al-farabi	al-fârâbî
solvation	solvatation
alchemy	alchimie
barotrauma	barotraumatisme
cpr-1000	cpr-1000
sofosbuvir	sofosbuvir
myocarditis	myocardite
acetone	acétone
feedback	rétroaction
civitas	civitas
hydrostatics	hydrostatique
flucloxacillin	flucloxacilline
callus	cal 
dhanvantari	dhanvantari
columbo	columbo
asclepeion	asclépiéion
convalescence	convalescence
benzbromarone	benzbromarone
child	enfant
precession	précession
virus	virus
pus	pus
kapalika	kapalika
halocline	halocline
bimaristan	bimaristan
levobupivacaine	lévobupivacaïne
mechanoreceptor	mécanorécepteur
orange 	orange 
pharmacokinetics	pharmacocinétique
creatinine	créatinine
hemoglobin	hémoglobine
3,4-methylenedioxyamphetamine	3,4-méthylènedioxyamphétamine
barbad	barbod
aspartame	aspartame
shiksha	shiksha
gliclazide	gliclazide
cholangiocarcinoma	cholangiocarcinome
poaching	braconnage
afro-asians	afro-asiatique
electronvolt	électronvolt
stretching	étirement
bacillus	bacillus
testicle	testicule
porosity	porosité
siderosis	sidérose 
satay	sate
loganiaceae	loganiaceae
kali	kali
heart 	heart 
arteriole	artériole
obesity	obésité
abdomen	abdomen
chersonesus	chersonèse 
pseudoscience	pseudoscience
deoxyribonucleotide	désoxyribonucléotide
epithelium	épithélium
lubiprostone	lubiprostone
hyperpigmentation	hyperpigmentation
semiconductor	semi-conducteur
lyssavirus	lyssavirus
miosis	myosis
pastis	pastis
ftsz	ftsz
ummah	oumma
legionella	legionella
weeze	weeze
jing 	jing 
homeostasis	homéostasie
tendon	tendon
enteroglucagon	entéroglucagon
prion	prion 
trastuzumab	trastuzumab
myosin	myosine
hashish	haschich
chromosome	chromosome
enasidenib	énasidénib
pericardium	péricarde
coevolution	coévolution
sphygmomanometer	tensiomètre
onchocerciasis	onchocercose
phase 	phase 
star	étoile
enterocolitis	entérocolite
actin	actine
brisbane	brisbane
neuropil	neuropile
panyassis	panyasis
sievert	sievert
bronchoscopy	bronchoscopie
cyproheptadine	cyproheptadine
torr	torr
dimer 	dimère
diastole	diastole
kemi	kemi
opiate	opiacé
endocrinology	endocrinologie
appendicitis	appendicite
perspiration	sueur
darmstadtium	darmstadtium
supernova	supernova
tulsidas	tulsîdâs
periostitis	périostite
pediatrics	pédiatrie
hippocras	hypocras
calcitriol	calcitriol
qiyas	qiyâs
odor	odeur
scn5a	scn5a
sacrum	sacrum
michelada	michelada
stoicism	stoïcisme
swimfin	palme 
alicudi	alicudi
xenoestrogen	xénoestrogène
fatigue	fatigue 
influenza	grippe
quebec	québec
epidermis	épiderme 
flavonoid	flavonoïde
pancytopenia	pancytopénie
carnitine	carnitine
pindar	pindare
stertor	stertor
butoconazole	butoconazole
cholesterol	cholestérol
sepsis	sepsis
oligomenorrhea	oligoménorrhée
lung	poumon
formulation	formulation
agility	agilité
asphyxia	asphyxie
civitas 	civitas 
tupuxuara	tupuxuara
teratology	tératologie
pons	pont 
dysphagia	dysphagie
steroid	stéroïde
aripiprazole	aripiprazole
inotrope	inotropisme
penfluridol	penfluridol
pseudomonadota	proteobacteria
methoxyethane	méthoxyéthane
haematopoiesis	hématopoïèse
histoplasmosis	histoplasmose
sacubitril/valsartan	valsartan
kif5a	kif5a
fibula	fibula
paraquat	paraquat
prednisone	prednisone
glipizide	glipizide
dicycloverine	dicyclovérine
soap	savon
cd3 	cd3
cyclopropane	cyclopropane
alimemazine	alimémazine
hassium	hassium
philippeion	philippéion
rudra	rudra
mitoxantrone	mitoxantrone
smoking	fumer
mercaptopurine	mercaptopurine
percentile	centile
convallatoxin	convallatoxine
benzylpiperazine	benzylpipérazine
hydrazide	hydrazide
azacitidine	azacitidine
tensor	tenseur
hecate	hécate
geriatrics	gériatrie
holism	holisme
stimulant	stimulant
oenanthotoxin	énanthotoxine
edema	œdème
coffee	café
rump 	croupe
ether	éther-oxyde
antioxidant	antioxydant
hemoglobin	hémoglobine
seminoma	séminome
infant	nourrisson
menopause	ménopause
adolescence	adolescence
pterion	ptérion
whistle	sifflet
oxide	oxyde
runx1	runx1
genetics	génétique
rickettsia	rickettsia
powder	poudre
harmaline	harmaline
amyloidosis	amylose 
empyema	empyème
england	angleterre
radha	radha
captodiame	captodiame
proteinopathy	protéinopathie
edema	œdème
elf	elfe
reptile	reptile
twin	jumeau
ureterostomy	urétérostomie
calgary	calgary
micrograph	photomicrographie
cypermethrin	cyperméthrine
doxycycline	doxycycline
diacetylene	butadiyne
vesicle 	vésicule 
echinocandin	échinocandine
surdas	surdas
angiography	angiographie
terina 	terina
akrai	akrai
cholecystokinin	cholécystokinine
gynaecology	gynécologie
asterixis	astérixis
poneratoxin	ponératoxine
peramivir	peramivir
xpo1	xpo1
nf-κb	nf-κb
al-zamakhshari	al-zamakhshari
benzophenone	benzophénone
glycosuria	glycosurie
thioxoethenylidene	thioxoéthénylidène
teplizumab	teplizumab
curette	curette
otitis	otite
bradykinin	bradykinine
ritual	rites
desmosome	desmosome
salt 	sel 
daidzein	daidzéine
copperbelt	copperbelt
drama 	drame 
immigration	immigration
agonist	agoniste 
aesop	ésope
myocarditis	myocardite
brahma	brahmā
kif5b	kif5b
4-fluoromethamphetamine	4-fluorométhamphétamine
dromotropic	dromotrope
encephalopathy	encéphalopathie
passivation 	passivation
potassium	potassium
gout	goutte 
ahamkara	ahamkara
cancer	cancer
tspan12	tspn12
bioavailability	biodisponibilité 
polymer	polymère
jupiter 	jupiter 
elliptocyte	ovalocyte
yohimbine	yohimbine
trichloroethylene	trichloréthylène
docetaxel	docétaxel
nitrendipine	nitrendipine
libido	libido 
calibration	étalonnage 
penicillamine	pénicillamine
dexchlorpheniramine	dexchlorphéniramine
methamidophos	méthamidophos
mīmāṃsā	mimamsa
carbapenem	carbapénème
balanitis	balanite
iatrogenesis	iatrogénèse
phenanthridine	phénanthridine
abscess	abcès
urology	urologie
myosin	myosine
tyras	tyras
sternum	sternum
oxomemazine	oxomémazine
drosophila	drosophile
graph 	graphe 
vasodilation	vasodilatateur
aponeurosis	aponévrose
paestum	paestum
dalit	intouchables 
dysmenorrhea	dysménorrhée
septoplasty	septoplastie
2c-p	2c-p
mosaic	mosaïque
vasodilation	vasodilatateur
tsikoudia	tsikoudiá
ichthyosis	ichtyose
ropivacaine	ropivacaïne
phosphorylation	phosphorylation
disease	maladie
telehealth	télémédecine
cathinone	cathinone
fibrate	fibrate
hydrocodone/ibuprofen	vicoprofen
bronchus	bronche
hemp	chanvre
cetacea	cetacea
guinea-bissau	guinée-bissau
cryotherapy	cryothérapie
triadin	triadine
norethisterone	noréthistérone
gums	gencive
mepacrine	quinacrine
polygenism	polygénisme
datura	datura
xamoterol	xamotérol
pyrene	pyrène 
melanin	mélanine
mydriasis	mydriase
adelaide	adélaïde 
isopropylphenidate	isopropylphénidate
alogliptin	alogliptine
balochistan	baloutchistan
pigment	pigment
sagunto	sagonte
tachycardia	tachycardie
immunodeficiency	immunodéficience
meddra	meddra
siemens 	siemens 
langley 	langley 
wikiversity	wikiversité
surfactant	tensioactif
ovary	ovaire
cephalosporin	céphalosporine
aquifer	aquifère
trismus	trismus 
ctenophora	ctenophora
palladium	palladium
reflex	réflexe
pseudocode	pseudo-code
fibrocyte	fibrocyte
paresthesia	paresthésie
capecitabine	capécitabine
neomycin	néomycine
romania	roumanie
jewellery	joaillerie
spironolactone	spironolactone
dimemebfe	dimemebfe
antibiotic	antibiotique
vasoconstriction	vasoconstriction
cilostazol	cilostazol
statistic	statistique 
recklessness 	insouciance 
tonne	tonne
digitalis	digitale
colorimeter 	colorimètre
graphene	graphène
menopause	ménopause
chebi	chebi
blepharospasm	blépharospasme
aggression	agression
comorbidity	comorbidité
ovoviviparity	ovoviviparité
applejack 	applejack
obinutuzumab	obinutuzumab
heart	cœur
percentage	pourcentage
antihistamine	antihistaminique
hypokalemia	hypokaliémie
sprint 	sprint 
immunology	immunologie
naxos 	naxos 
citrus	citrus
bacillota	firmicutes
diuretic	diurétique
zechstein	zechstein
sarcomere	sarcomère
roentgen 	röntgen
pharynx	pharynx
grappa	grappa
hypercholesterolemia	hypercholestérolémie
pharmacovigilance	pharmacovigilance
systole	systole
lipopolysaccharide	lipopolysaccharide
glycoside	hétéroside
retinopathy	rétinopathie
folliculogenesis	folliculogénèse
geography	géographie
currency	devise 
acidosis	acidose
fuzuli 	fuzûlî
proteolysis	protéolyse
bosentan	bosentan
harissa	harissa
colitis	colite
lipid	lipide
hyponatremia	hyponatrémie
streptomyces	streptomyces
bacteria	bactérie
miconazole	miconazole
bureaucracy	bureaucratie
milrinone	milrinone
khwarazm	khwarezm
3-iodothyronamine	3-iodothyronamine
ethosuximide	éthosuximide
conotoxin	conotoxine
efficiency 	efficacité 
rutherfordium	rutherfordium
batoidea	raie
artephius	artéphius
evinacumab	evinacumab
pharyngitis	pharyngite
arabization	arabisation
hepatomegaly	hépatomégalie
philopatry	philopatrie
korn 	korn 
histone	histone
hylomorphism	hylémorphisme
virus	virus
hypercalcaemia	hypercalcémie
coca-cola	coca-cola
gland	glande
phragmoplast	phragmoplaste
treprostinil	tréprostinil
epaminondas	épaminondas
radionuclide	radioisotope
authority	autorité
bronchiole	bronchiole
ultracentrifuge	ultracentrifugeuse
linezolid	linézolide
poliovirus	poliovirus
selenium	sélénium
vejovis	vejove
quarantine	quarantaine
casabona	casabona 
nifurtimox	nifurtimox
sita	sītā
cochrane 	cochrane 
pilgrim	pèlerin
flushing 	rougissement 
abiward	abiverd
asclepeion	asclépiéion
neoplasm	néoplasie
rauvolfia	rauvolfia
asparagaceae	asparagaceae
orthopnea	orthopnée
autopsy	autopsie
kwashiorkor	kwashiorkor
chlamydia	chlamydiose
paper	papier
hyperglycemia	hyperglycémie
algorithm	algorithme
yaws	pian 
mucus	mucus
arithmetic	arithmétique
horace	horace
dam	barrage
hospice 	hospice 
avempace	avempace
erythropoietin	érythropoïétine
galactoside	galactoside
anticoagulant	anticoagulant
titration	titrage
canagliflozin	canagliflozine
cryolite	cryolite
myofibril	myofibrille
pheochromocytoma	phéochromocytome
oxygen	oxygène
salzburg	salzbourg
allopurinol	allopurinol
hcn4	hcn4
infestation	infestation 
benfluorex	benfluorex
glycerol	glycérol
thallium	thallium
atlas 	atlas 
prazosin	prazosine
jwh-018	jwh-018
well-being	bien-être
atherosclerosis	athérosclérose
amphibian	amphibia
pitsunda	pitsounda
endocardium	endocarde
xanthine	xanthine
leptospirosis	leptospirose
sugilite	sugilite
tincture	alcoolature
tetraodontidae	poisson-globe
alkalosis	alcalose
natriuresis	natriurèse
herg	herg
antibiotic	antibiotique
gossypol	gossypol
paranormal	paranormal
minneapolis	minneapolis
endocarditis	endocardite
rice	riz
grog	grog
anagrelide	anagrélide
tannin	tanin
sulfadiazine	sulfadiazine
tax	impôt
shaivism	shivaïsme
constantinople	constantinople
nightmare	cauchemar
carbamazepine	carbamazépine
cocktail	cocktail
ionophore	ionophore
hebei	hebei
andrology	andrologie
ximelagatran	ximélagatran
profilin	profiline
hfe 	hfe 
thtr-300	thtr-300
jurisdiction	compétence 
sighthound	lévrier
za'atar	zaatar
osmosis	osmose
allergy	allergie
thiazolidinedione	thiazolidinedione
truth	vérité
ciprofloxacin	ciprofloxacine
oxiconazole	oxiconazole
pycnodysostosis	pycnodysostose
wollastonite	wollastonite
cameroon	cameroun
thesis	thèse
al-a'sha	al-aʿšā
nutrient	nutriment
2c-d	2c-d
rodent	rodentia
ctenophora	ctenophora
photoconductivity	photoconductivité
sacubitril/valsartan	valsartan
microwave	micro-onde
schnapps	schnaps
animal	animal
cestoda	cestoda
neptunium	neptunium
padua	padoue
tioconazole	tioconazole
carcinogen	cancérogène
pathophysiology	physiopathologie
self-diagnosis	auto-diagnostic
xenotransplantation	xénogreffe
archaeology	archéologie
immortality	immortalité
hand	main
lung	poumon
agriculture	agriculture
frog	anoures
hydroxyproline	hydroxyproline
siphon	siphon 
epilepsy	épilepsie
endothelium	endothélium
elbow	coude
mesenchyme	mésenchyme
flight	vol 
epithelium	épithélium
watch	montre 
metastasis	métastase 
lucan	lucain
sucralose	sucralose
atelectasis	atélectasie
fluoroscopy	fluoroscopie
osteoclast	ostéoclaste
lecce	lecce
mitochondrion	mitochondrie
stamen	étamine
cataract	cataracte 
etonogestrel	etonogestrel
silicosis	silicose
cytotoxicity	cytotoxicité
mucin	mucine
dysthymia	dysthymie
trandolapril	trandolapril
dog	chien
enterobacteriaceae	enterobacteriaceae
marzipan	massepain
monocyte	monocyte
miglitol	miglitol
jejunum	jéjunum
methylhexanamine	méthylhexanamine
phalanx	phalange 
prostaglandin	prostaglandine
hermetica	hermetica
her2/neu	her2
meninges	méninges
sadhguru	sadhguru
addiction	addiction
cough	toux
phosphine	phosphine
apnea	apnée
remscheid	remscheid
achourya	asteya
abortion	avortement
woodcut	xylographie
podalirius	podalire
defibrillation	défibrillation
neoplasm	néoplasie
medicine	médecine
taboo	tabou
crocodilia	crocodilia
pascal 	pascal 
cream	crème 
prohormone	prohormone
tranquilandia	tranquilandia
tamarind	tamarinier
hypertriglyceridemia	hypertriglycéridémie
corynebacterium	corynebacterium
mimesis	mimèsis
splenomegaly	splénomégalie
epibatidine	épibatidine
pushan	pushan
medicine	médecine
maryland	maryland
combitube	combitube
upanishads	upanishad
beta-carboline	β-carboline
osteoporosis	ostéoporose
epistemology	épistémologie
bibliotherapy	bibliothérapie
onychomycosis	onychomycose
electrocardiography	électrocardiographie
piracetam	piracétam
parthenon	parthénon
mongols	mongols
stupor	stupeur
pueraria	pueraria
coagulase	coagulase
anasarca	anasarque
syndrome	syndrome
narcotic	narcotique
thermoplastic	thermoplastique
antidote	antidote
rickets	rachitisme
trachoma	trachome
massage	massage
receptor 	récepteur 
caecilian	gymnophiona
histiocyte	histiocyte
kriging	krigeage
ramucirumab	ramucirumab
crocodile	crocodile
penhaligon's	penhaligon's
sulbutiamine	sulbutiamine
abstinence	abstinence
cannula	canule
diazoxide	diazoxide
algorithm	algorithme
spirometry	spirométrie
semustine	sémustine
transaminase	transaminase
aztecs	aztèques
feldspar	feldspath
anemia	anémie
kos	kos 
tremor	tremblement
persians	persans
cyanosis	cyanose
granulocyte	granulocyte
reticulocyte	réticulocyte
strasbourg	strasbourg
cetirizine	cétirizine
boiling	ébullition
hypercholesterolemia	hypercholestérolémie
nitrosamine	nitrosamine
bronchus	bronche
bundahishn	bundahishn
fluphenazine	fluphénazine
secretoneurin	secrétoneurine
montevideo	montevideo
leukemia	leucémie
stomach	estomac
fasciolosis	fasciolose
hemolysis	hémolyse
ultraviolet	ultraviolet
armagnac	armagnac 
electrogastrogram	électrogastrographie
cyanopolyyne	cyanopolyyne
formaldehyde	méthanal
gynura	gynura
hookah	narguilé
diastereomer	diastéréoisomérie
halal	halal
carvedilol	carvédilol
electrolyte	électrolyte
litre	litre
quadrupedalism	quadrupédie
drop 	goutte 
motility	motilité
pneumothorax	pneumothorax
radiosurgery	radiochirurgie
cultivar	cultivar
angle	angle
tyrannosaurus	tyrannosaurus
centrosome	centrosome
hirudin	hirudine
botany	botanique
hermetica	hermetica
sun	soleil
chills	frissonnement
metandienone	méthandrosténolone
scorpion	scorpiones
kinesiology	kinésiologie
hydrometallurgy	hydrométallurgie
adinazolam	adinazolam
ketoacidosis	acidocétose
potentiator	potentialisateur
sukhumi	soukhoumi
determinism	déterminisme
sardinia	sardaigne
dobermann	dobermann
cryoprecipitate	cryoprécipité
esophagus	œsophage
nonbenzodiazepine	non-benzodiazépine
artephius	artéphius
antifungal	antimycosique
photodermatitis	photosensibilisation
migraine	migraine
tomotherapy	tomothérapie
asepsis	asepsie
vinblastine	vinblastine
myalgia	myalgie
ezetimibe	ézétimibe
dizziness	étourdissement
therapy	traitement 
posaconazole	posaconazole
trimethylamine	triméthylamine
parenchyma	parenchyme
cardiomyopathy	cardiomyopathie
sciatica	lombosciatique
nagarjuna	nāgārjuna
aquanaut	aquanaute
hemosiderosis	hémosidérose
serology	sérologie
tesla 	tesla 
snus	snus
nitrite	nitrite
hypoalgesia	hypoalgésie
thromboxane	thromboxane
paideia	paideia
dhātu 	dhātu
lysander	lysandre
vishnu	vishnou
dharma	dharma
moldova	moldavie
upadacitinib	upadacitinib
sulfhemoglobinemia	sulfhémoglobinémie
uveitis	uvéite
clonus	clonus
conjunctiva	conjonctive
ion	ion
belgium	belgique
infection	infection
mamba	dendroaspis
procalcitonin	procalcitonine
düsseldorf	düsseldorf
dnyaneshwar	jnaneshvara
guangzhou	canton 
fluorodeoxyglucose 	fluorodésoxyglucose 
anosmia	anosmie
pupil	pupille
rimonabant	rimonabant
ephesus	éphèse
astrovirus	astroviridae
kelvin	kelvin
syphilis	syphilis
carfilzomib	carfilzomib
biorhythm 	biorythme
sesamin	sésamine
ramakrishna	râmakrishna
pseudo-democritus	pseudo-démocrite
mycobacterium	mycobacterium
meninges	méninges
lymphedema	lymphœdème
sanitation	assainissement
acetamide	acétamide
chakra	chakra
philia	philia
framing 	cadrage 
physostome	physostome
erdafitinib	erdafitinib
proopiomelanocortin	proopiomélanocortine
hyperthyroidism	hyperthyroïdie
medlineplus	medlineplus
sacrum	sacrum
green	vert
piperidine	pipéridine
ayurveda	ayurveda
hyperoside	hypéroside
hafiz 	hafiz 
kaṇāda 	kanada
hermetica	hermetica
arabic	arabe
dexlansoprazole	dexlansoprazole
pms2	pms2
ertugliflozin	ertugliflozine
coltan	coltan
freckle	éphélide
ephedrine	éphédrine
meclizine	méclozine
tetracaine	tétracaïne
ara 	arag
tritium	tritium
amitriptyline	amitriptyline
bicarbonate	bicarbonate
callus 	cal 
glucoside	glucoside
abciximab	abciximab
pharmacokinetics	pharmacocinétique
pasteurization	pasteurisation
reinforcement	renforcement
glutaminase	glutaminase
erythrasma	érythrasma
mediastinum	médiastin
ecgonine	ecgonine
moksha	moksha
erasistratus	érasistrate
vasopressin	vasopressine
digoxin	digoxine
oligomer	oligomère
snoring	ronflement
vitruvius	vitruve
phagocyte	phagocyte
ptprc	cd45
centenarian	centenaire
meciadanol	méciadanol
plasmid	plasmide
neptunite	neptunite
vindesine	vindésine
theriac	thériaque
cd40 	cd40
screwdriver 	screwdriver
etoposide	étoposide
tetany	tétanie
disproportionation	dismutation
novartis	novartis
amerasian	amérasien
picrotoxin	picrotoxine
potassium	potassium
plakoglobin	plakoglobine
ethology	éthologie
denkard	denkard
ustekinumab	ustékinumab
enzyme	enzyme
opioid	opioïde
median	médiane 
stenosis	sténose
bearing 	palier 
aripiprazole	aripiprazole
phenylephrine	phényléphrine
nucleosynthesis	nucléosynthèse
trabeculectomy	trabéculectomie
diphenadione	diphacinone
cytisinicline	cytisine
lactobacillus	lactobacille
hemiballismus	hémiballisme
épaulard	épaulard 
sultopride	sultopride
hirsutism	hirsutisme
christianity	christianisme
kcnj14	kir2.4
charango	charango
zeranol	zeranol
tianeptine	tianeptine
wart	verrue
physiology	physiologie
imhotep	imhotep
residency 	résidence 
eicosanoid	eicosanoïde
fibrinolysis	fibrinolyse
puthandu	puthandu
metabolism	métabolisme
thrombus	thrombus
fluorescence	fluorescence
pymol	pymol
blinatumomab	blinatumomab
paxilline	paxilline 
ambulance	ambulance
microorganism	micro-organisme
alabama	alabama
coca-cola	coca-cola
lymphadenopathy	adénopathie
liver	foie
electrophoresis	électrophorèse
anti-inflammatory	anti-inflammatoire
memoization	mémoïsation
