laminopathy	laminopathie
brazil	brazilië
doxycycline	doxycycline
vardenafil	vardenafil
murder	moord
velia	elea
hobby	hobby
diastole	diastole 
veterinarian	dierenarts
leukocytosis	leukocytose
gjb2	connexine-26-mutatie
hip	heup
semarang	semarang 
menarche	menarche
acetaldehyde	aceetaldehyde
ovary	eierstok
hebei	hebei
translation 	translatie 
glycosaminoglycan	glycosaminoglycaan
dermatome 	dermatoom 
coke 	cokes
thiamine	thiamine
sacrum	heiligbeen
progestogen	progestageen
aripiprazole	aripiprazol
weir	stuw
hydrophile	hydrofiel
echocardiography	echocardiografie
haptoglobin	haptoglobine
steatorrhea	steatorroe
orujo	orujo
supernova	supernova
brainstem	hersenstam
x-ray	röntgenstraling
bloodletting	aderlaten
immunotherapy	immunotherapie
endothelium	endotheel
coagulation	bloedstolling
tellurium	telluur
cortisone	cortison
bangalore	bangalore
anticoagulant	anticoagulantia
vertebra	wervel 
meninges	hersenvliezen
screening 	bevolkingsonderzoek
kelp	kelp
ouzo	ouzo
lymphedema	lymfoedeem
vertebra	wervel 
miconazole	miconazol
kapila	kapila
allergy	allergie
ayurveda	ayurveda
anticonvulsant	anti-epileptica
hypercholesterolemia	hypercholesterolemie
danazol	danazol
physiology	fysiologie
caraway	karwij
lung	long 
amplitude	amplitude
ytterbium	ytterbium
sulfur	zwavel
bedding	beddengoed
prednisone	prednison
biomolecule	biomolecuul
menander	menander 
1,10-phenanthroline	1,10-fenantroline
amygdalin	amygdaline
phenylpiracetam	carfedon
phosphorylation	fosforylering
morphine	morfine
etomidate	etomidaat
fluspirilene	fluspirileen
aranyaka	aranyaka
rebranding	rebranding
chloroform	chloroform
rome	rome 
galvanometer	galvanometer
offal	orgaanvlees
exanthem	exantheem
myc	myc
acetylation	acetylering
edema	oedeem
balanitis	balanitis
triflupromazine	triflupromazine
shiitake	shiitake
gas	gas 
pythagoreanism	pythagorisme 
gastrin	gastrine
malaria	malaria
cholera	cholera
triathlon	triatlon
nucleoporin	nucleoporine
agar	agaragar
glycoside	glycoside
3-methylmethcathinone	3-methylmethcathinon
boeotia	boeotië
cricothyrotomy	coniotomie
satureja	bonenkruid
aligarh	aligarh 
carnosine	carnosine
protagoras 	protagoras 
epigenetics	epigenetica
sacrum	heiligbeen
pulmonata	longslakken
electrolyte	elektrolyt
schadenfreude	leedvermaak 
mantra	mantra
reflexology	reflexologie
zuclopenthixol	zuclopentixol
cytotoxicity	cytotoxine
ischemia	ischemie
minoxidil	minoxidil
propionitrile	propaannitril
losartan	losartan
yohimbine	yohimbine
catecholamine	catecholamine
sulconazole	sulconazol
gestation	gestatie
morphology 	morfologie 
alternariol	alternariol
embryology	embryologie
nitrate	nitraat
opisthotonus	opisthotonus
46,xx/46,xy	46,xy
hermetica	hermetica
poise 	poise
water	water
hope	hoop
homology 	homologie 
fermium	fermium
science 	science
vaginitis	vaginitis
spirometer	spirometer
autobiography	autobiografie
futon	futon
levitation 	levitatie 
hepatotoxicity	hepatotoxiciteit
oophorectomy	oöforectomie
tensor	tensor
tracheotomy	tracheotomie
horticulture	horticultuur
dandruff	roos 
locust	treksprinkhanen
quimper	quimper
tupuxuara	tupuxuara
rickettsia	rickettsia
sumac	sumak 
hyperthyroidism	thyreotoxicose
rhinitis	rinitis
kenya	kenia
push-up	opdrukken 
sonar	sonar
brahmin	brahmaan
spinach	spinazie
deforestation	ontbossing
mnemonic	ezelsbruggetje
1,3-diaminopropane	1,3-propaandiamine
recursion	recursie
pericardium	pericard
ventricle 	ventrikel 
ainhum	ainhum
fat	vet
gorgias	gorgias
tetanus	tetanus
pramana	pramana
vinflunine	vinflunine
automation	automatisering
sarcomere	sarcomeer
menopause	menopauze
tropicos	tropicos
langbeinite	langbeiniet
cough	hoest
bronchoscopy	bronchoscopie
virgil	vergilius
cyanamide	cyaanamide
otorhinolaryngology	otorinolaryngologie
history	geschiedenis
beryllium	beryllium
laryngospasm	laryngospasme
coccus	kokken
clostridia	clostridia
glufosinate	glufosinaat
electricity	elektriciteit
hydrosphere	hydrosfeer
progesterone	progesteron
tension 	rekspanning
occult	occultisme
atrium 	atrium 
l-selectride	l-selectride
lethargy	lethargie
kassites	kassieten
nocturia	nycturie
arrhythmia	hartritmestoornis
embolization	embolisatie
axilla	oksel
hemichordate	kraagdragers
anesthetic	anesthetica
syndactyly	syndactylie
levocetirizine	levocetirizine
prototype	prototype
massage	massage
ivabradine	ivabradine
gallium	gallium
plantaginaceae	weegbreefamilie
cofactor 	cofactor 
dmoz	dmoz
mexico	mexico 
soybean	sojaboon
antipsychotic	antipsychotica
thiamphenicol	thiamfenicol
paracoccidioidomycosis	paracoccidioidomycosis
spleen	milt
dendrite	dendriet 
polymorphism 	polymorf 
otosclerosis	otosclerose
meitnerium	meitnerium
heart	hart
acupuncture	acupunctuur
wavelength	golflengte
tax	belasting 
tajikistan	tadzjikistan
wade–giles	wade-giles
aldicarb	aldicarb
amsterdam	amsterdam
toxicity	giftigheid
insomnia	slapeloosheid
dam	dam 
euphoria	euforie
fascia	fascie 
quetiapine	quetiapine
sensu	sensu
tap 	kraan 
paralysis	verlamming
irbesartan	irbesartan
monocyte	monocyt
proligestone	proligeston
mastocytosis	mastocytose
quinapril	quinapril
sambucus	vlier 
sirenia 	sirenia 
pons	pons 
port	haven
humectant	bevochtigingsmiddel
burn	brandwond
integrin	integrine
thyroid	schildklier
coagulation	bloedstolling
influenza	griep
chalcis	chalkis 
vertex 	vertex 
phragmoplast	fragmoplast
blastocyst	blastocyste
germline	kiembaan
ethinylestradiol	ethinylestradiol
herb	kruid 
stoichiometry	stoichiometrie
borneol	borneol
immunotherapy	immunotherapie
korn 	kornbrand
genealogy	genealogie 
angiogenesis	angiogenese
alkali	alkali
compassion	medelijden
nutrien	nutrien
orlistat	orlistat
perception	waarneming 
trachea	luchtpijp
necrosis	necrose
tyrtaeus	tyrtaeus
nihilism	nihilisme 
comet	komeet
miscarriage	miskraam
clotiazepam	clotiazepam
fetus	foetus
dysprosium	dysprosium
semi-vegetarianism	semi-vegetarisme
placenta	placenta
dubnium	dubnium
paruresis	paruresis
deuterostome	deuterostomia
rhodamine	rhodamine
tibia	scheenbeen
leukoplakia	leukoplakie
khaqani	khaqani
dermatomyositis	dermatomyositis
ventricle 	ventrikel 
transistor	transistor
anesthetic	anesthetica
vertebra	wervel 
diacetylene	diacetyleen
nutrient	voedingsstof
anagrelide	anagrelide
psychoacoustics	psychoakoestiek
phenotype	fenotype
coxsackievirus	coxsackievirus
rimonabant	rimonabant
genus	geslacht 
anosmia	anosmie
rash	huiduitslag
kiel	kiel 
zester	zesteur
fetus	foetus
hybrid 	hybride 
neoplasm	neoplasie
endocarditis	endocarditis
actinomyces	actinomycetes
medication	geneesmiddel
2,4-dinitrophenylhydrazine	2,4-dinitrofenylhydrazine
ligature 	ligatuur 
monograph	monografie
tranquilizer	tranquillizer
brexit	brexit
allotransplantation	allotransplantatie
rifampicin	rifampicine
kelvin	kelvin 
aorta	aorta
infrasound	infrageluid
fenugreek	fenegriek
substrate 	substraat 
loperamide	loperamide
endogeny 	endogeen 
parosmia	parosmie
graphite	grafiet
cumberland	cumberland 
leflunomide	leflunomide
intron	intron
probability	kans 
porpoise	bruinvissen
naproxen	naproxen
wildlife	wildlife 
vitallium	vitallium
enna	enna 
sense 	sense 
cognition	cognitie
methylenedioxypyrovalerone	methyleendioxypyrovaleron
paper	papier
orexin	orexine
thiamine	thiamine
chlormethine	chloormethine
hepatitis	leverontsteking
țuică	țuică
jurist	jurist
liquorice	zoethout
experiment	experiment
metalloproteinase	metalloprotease
brewing	bierbrouwen
hadith	hadith
compliance 	compliantie
asclepius	asklepios
17α-hydroxyprogesterone	17-oh-progesteron
gallup 	gallup 
clotrimazole	clotrimazol
rosicrucianism	rozenkruisers
jāti	jati 
hirsutism	hirsutisme
cafestol	cafestol
vermiculite	vermiculiet
polymer	polymeer
pneumothorax	pneumothorax
rubella	rodehond
avicenna	avicenna
phencyclidine	fencyclidine
transferase	transferase
colombia	colombia
aorta	aorta
bronchitis	bronchitis
hydrochlorothiazide	hydrochloorthiazide
anemone	anemoon
system	systeem 
butane	butaan
disease	ziekte
myosin	myosine
ramakrishna	ramakrishna
writing	schrijven
volt	volt 
osteoblast	osteoblast
panchatantra	pañcatantra
phenylalanine	fenylalanine
vasoconstriction	vasoconstrictie
pharmacodynamics	farmacodynamiek
prosthesis	prothese
erythrite	erytriet
polyyne	polyyn
orphanet	orphanet
rubidium	rubidium
boiling	koken 
shame	schaamte
arabs	arabieren
betahistine	bètahistine
phronesis	phronèsis
hyperglycemia	hyperglykemie
cannabinoid	cannabinoïde
mammal	zoogdieren
palpitations	hartklopping
lotion	lotion
venipuncture	venapunctie
bilirubin	bilirubine
optometry	optometrie
saturn 	saturnus 
actin	actine
graffiti	graffiti
xenon	xenon
gal 	gal 
blue	blauw 
stretching	stretching
vasodilation	vasodilatatie
hives	netelroos
inharmonicity	inharmoniciteit
ranitidine	ranitidine
beerse	beerse
fraud	fraude
chandra	soma 
transoxiana	transoxanië
mimesis	mimesis
aristolochia	aristolochia
purine	purine
psychopathology	psychopathologie
nocturia	nycturie
dexter 	dexter 
pescetarianism	pescotarisme
ageing	veroudering 
christchurch	christchurch 
pregabalin	pregabaline
lipedema	lipoedeem
heart	hart
ivabradine	ivabradine
anglesite	anglesiet
science	wetenschap
therapy	therapie
sozopol	sozopol
autophagy	autofagie 
elastase	elastase
heracles	herakles 
agonist	agonist 
zopiclone	zopiclon
fomite	fomiet
actuary	actuaris
bleeding	bloeding
poliovirus	poliovirus
lithium 	lithiumtherapie
rosicrucianism	rozenkruisers
digitalis	vingerhoedskruid 
phenol	fenol
physiology	fysiologie
moth	nachtvlinder 
paprika	paprikapoeder
hookah	waterpijp
sewage	afvalwater
atrium 	atrium 
rutherfordium	rutherfordium
actinomycosis	actinomycose
yakitori	yakitori
freedom	vrijheid 
kir2.1	kir2.1
crystallinity	kristalliniteit
armenia	armenië
trance	trance 
cetacea	walvisachtigen
hour	uur
cachexia	cachexie
labetalol	labetalol
sting 	sting 
herbicide	herbicide
yemen	jemen
arrhythmia	hartritmestoornis
electronegativity	elektronegativiteit
underdrawing	ondertekening
psoriasis	psoriasis
necrophilia	necrofilie
pharmacy	farmacie
latanoprost	latanoprost
jordan	jordanië
ethylene	etheen
ischemia	ischemie
australia	australië 
alkylation	alkylering
4-fluoroamphetamine	4-fa
sarcoidosis	sarcoïdose
heidelberg	heidelberg 
capillary	haarvat
mississippi	mississippi 
lymph	lymfe
lymphangitis	lymfangitis
microsoft	microsoft
nail 	nagel 
homelessness	dakloosheid
melasma	melasma
flow 	flow 
landscape	landschap
aneurysm	aneurysma
lymph	lymfe
itihasa	itihasa
nitrox	nitrox
symphytum	smeerwortel
glycosuria	glucosurie
ultraviolet	ultraviolet
supersymmetry	supersymmetrie
stromboli	stromboli 
cysteine	cysteïne
ankara	ankara
serca	serca
scalpel	scalpel
euphoria	euforie
carprofen	carprofen
aquanaut	aquanaut 
concentration	concentratie 
rajasthan	rajasthan
melasma	melasma
brine	pekel
methanethiol	methaanthiol
ranunculaceae	ranonkelfamilie
skin	huid
dihydroxyacetone	dihydroxyaceton
foreskin	voorhuid
humorism	humores
litre	liter
electrophile	elektrofiel
anagrelide	anagrelide
dubnium	dubnium
infrared	infrarood
tendon	pees 
babylonia	babylonië
hyperpigmentation	hyperpigmentatie
acupuncture	acupunctuur
rakı	raki
flexibility 	flexibiliteit
fibrosis	fibrose
edema	oedeem
fatigue	fatigue
belief	geloof
fibrinolysis	fibrinolyse
heparin	heparine
ammonium	ammonium
haloalkane	halogeenalkaan
moksha	moksha
condom	condoom
aquifer	aquifer
lung	long 
philanthropy	filantropie
opiate	opiaten
mucus	slijm
agonist	agonist 
ozone	ozon 
citrus	citrus 
mutation	mutatie 
teetotalism	geheelonthouding
crusades	kruistocht
biochemistry	biochemie
cytokine	cytokine
1,10-phenanthroline	1,10-fenantroline
carbohydrate	koolhydraat
elemental	elementaal
drambuie	drambuie
quinoline	chinoline
eswatini	swaziland
thrombolysis	trombolyse
macedonia 	macedonië 
arak 	arak 
lemma 	lemma 
hunger	honger
myelin	myeline
dysplasia	dysplasie
secretion	secretie
fungus	schimmels
hafiz 	hafiz 
tocofersolan	tocofersolan
photodermatitis	fotocontactallergie
metaphysics	metafysica
peru	peru
inquest	lijkschouw
artery	slagader
bureaucracy	bureaucratie
oricum	oricum
palmitoylethanolamide	palmitoylethanolamide
cat	kat 
pyelogram	pyelogram
ester	ester 
dysentery	dysenterie
cholecystokinin	cholecystokinine
zirconium	zirkonium
pneumonectomy	pneumectomie
medication	geneesmiddel
benzodiazepine	benzodiazepine
cathine	cathine
carteolol	carteolol
transudate	transsudaat
promyelocyte	promyelocyt
granuloma	granuloom
cuirass	kuras
psychedelia	psychedelisch
incidence 	incidentie
syncope 	syncope 
histone	histon 
phosphatidylcholine	fosfatidylcholine
buprenorphine	buprenorfine
imidazole	imidazool
mometasone	mometasonfuroaat
immigration	immigratie
enterococcus	enterococcus
gasket	afdichting
muridae	muridae
emir	emir
amygdalin	amygdaline
ultrasound	ultrageluid
denmark	denemarken
rofecoxib	rofecoxib
glimepiride	glimepiride
acrolein	acroleïne
trimethoxyamphetamine	trimethoxyamfetamine
ostracism	ostracisme
cytochrome	cytochroom
krishna	krishna 
levee	dijk 
anhedonia	anhedonie
cestoda	lintwormen
hydrostatics	hydrostatica
arrhythmia	hartritmestoornis
aflibercept	aflibercept
rheology	reologie
endocardium	endocard
electrocardiography	elektrocardiogram
furosemide	furosemide
isomerase	isomerase
infection	infectie
mirtazapine	mirtazapine
ligand	ligand
electronvolt	elektronvolt
skull	schedel
heuristic	heuristiek
empiricism	empirisme
neurotransmitter	neurotransmitters
oklahoma	oklahoma
x-ray	röntgenstraling
fentanyl	fentanyl
aspergilloma	aspergilloom
infection	infectie
boulangerite	boulangeriet
pretzel	pretzel
pharmacist	apotheker
polytetrafluoroethylene	teflon
asthma	astma
carcinoma	carcinoom
newsweek	newsweek
methylone	methylone
disease	ziekte
mourning	rouw
confederation	confederatie
anthropology	antropologie
dressing 	verband 
genecards	genecards
thebaine	thebaïne
ophthalmology	oogheelkunde
ventricle 	ventrikel 
naples	napels 
eosin	eosine
entacapone	entacapone
thymine	thymine
koinon	koinon
bust 	buste 
damascus	damascus
circulation 	circulation
anticoagulant	anticoagulantia
heracleum 	berenklauw 
epiglottis	strotklepje
denotation	denotatie
virus	virus 
nicotiana	nicotiana
icd-10	icd-10
carbon	koolstof
memantine	memantine
orange 	oranje 
bichir	kwastsnoeken
census	volkstelling
daratumumab	daratumumab
hermetica	hermetica
mining	mijnbouw
tapentadol	tapentadol
cytomegalovirus	cytomegalovirus
lisinopril	lisinopril
niacin	nicotinezuur
tonsil	keelamandel
caesium	cesium
glycoside	glycoside
microtome	microtoom
infestation	infestatie
germanium	germanium
antiemetic	anti-emetica
mole 	mol 
dehydration	dehydratie 
individualism	individualisme
alcohol 	alcohol 
pharyngitis	keelontsteking
range 	spreidingsbreedte
medlineplus	medlineplus
conotoxin	conotoxine
heart	hart
geographer	geograaf
palonosetron	palonosetron
solvent	oplosmiddel
screwdriver 	screwdriver
toothbrush	tandenborstel
epidemic	epidemie
virotherapy	virotherapie
kirsch	kirsch
cancer 	cancer
latvia	letland
multivitamin	multivitamine
injury	verwonding
pyrimidine	pyrimidine
ischemia	ischemie
disease	ziekte
saudade	saudade
asystole	asystolie
soma 	perikaryon
cholesterol	cholesterol
neuromodulation	neuromodulatie
regret	spijt
dementia	dementie
prokaryote	prokaryoten
drink	drank
lungfish	longvissen
arteriosclerosis	arteriosclerose
vincristine	vincristine
bouncer	uitsmijter 
jenever	jenever
fibronectin	fibronectine
pediatrics	pediatrie
antioxidant	antioxidant
haloalkane	halogeenalkaan
syndrome	syndroom 
trisomy	trisomie
aducanumab	aducanumab
hiv/aids	aids
burping	boer 
tablet 	tablet
cholinesterase	cholinesterase
sulfanilamide	sulfapreparaat
mathworld	mathworld
lens	lens 
whisky	whisky
interpol	interpol
bar-back	barback
genotype	genotype
serology	serologie
shakti	shakti
wetherspoons	wetherspoon
vertebra	wervel 
calculator	rekenmachine
rigveda	rigveda
medicine	geneeskunde
family	familie 
streptococcus	streptokokken
pasteurization	pasteuriseren
meta-analysis	meta-analyse
website	website
snake	slangen
anatomy	anatomie
docetaxel	docetaxel
bed	bed
sugammadex	sugammadex
neidan	neidan
asthma	astma
metamorphoses	metamorfosen 
mouthwash	mondwater
poison	vergif
triiodothyronine	tri-joodthyronine
bone	bot 
lipolysis	lipolyse
antiseptic	antisepticum
colonialism	kolonialisme
epistemology	kennistheorie
cell 	cel 
bioinformatics	bio-informatica
curare	curare
stegosaurus	stegosaurus
leaf	blad
natalizumab	natalizumab
pyrazolidine	pyrazolidine
pregnancy	zwangerschap
endothelium	endotheel
tannin	tannine
sparta	sparta 
rheumatology	reumatologie
defibrillation	defibrillatie
osteichthyes	beenvisachtigen
histology	histologie
neutropenia	neutropenie
trogir	trogir
blepharospasm	blefarospasme
world	wereld 
lesion	laesie
astrocyte	astrocyt
dermatology	dermatologie
hematemesis	bloedbraken
hypnopompic	hypnopompie
aquaporin	aquaporine
laughter	lachen 
transcriptome	transcriptoom
methamphetamine	methamfetamine
electrocardiography	elektrocardiogram
creatinine	creatinine
tide	getijde 
basidiomycota	basidiomyceten
purpura	purpura 
sydney	sydney
panchatantra	pañcatantra
sumer	sumer
gochujang	gochujang
antacid	antacida
anakinra	anakinra
electronegativity	elektronegativiteit
mathematics	wiskunde
cyst	cyste
flowchart	stroomdiagram
biopharmaceutical	biological
concentration	concentratie 
coagulation	bloedstolling
hallucinogen	hallucinogeen
tarragon	dragon 
mumbai	bombay
serine	serine
vivisection	vivisectie
bronchiectasis	bronchiëctasieën
urbanization	verstedelijking
stress 	stress
acid	zuur 
brittany	bretagne 
mefloquine	mefloquine
hafnium	hafnium
predation	predatie
dynorphin	dynorfine
benzodiazepine	benzodiazepine
hydroxylation	hydroxylering
patient	patiënt
clostridium	clostridium
fire 	vuur 
radon	radon 
muti	muti 
ventricle 	ventrikel 
vulva	vulva
edema	oedeem
transcription 	transcriptie 
tincture	tinctuur 
lung	long 
sputum	sputum
cystography	cystografie
burping	boer 
cd14	cd14
pharynx	farynx
human	mens
medlineplus	medlineplus
syndrome	syndroom 
sicily	sicilië
skull	schedel
angiography	angiografie
whisky	whisky
naloxone	naloxon
cinnamon	kaneel
haecceity	haecceitas
flatworm	platwormen
vanilla	vanille
flooding 	flooding 
affix	affix
haloperidol	haloperidol
verapamil	verapamil
pandemic	pandemie
piperidine	piperidine
titin	titine
exercise	lichaamsbeweging
psychoanalysis	psychoanalyse
tilidine	tilidine
temperament	temperament
epididymitis	epididymo-orchitis
bmpr2	bmpr2
galactosemia	galactosemie
ammonia	ammoniak
zolpidem	zolpidem
erythrasma	erythrasma
autopsy	autopsie
atheroma	plaque 
shark	haaien
hippeis	hippeis
fluid	fluïdum
filicudi	filicudi
ebolavirus	ebolavirus
supercompensation	supercompensatie
asphyxia	verstikking
oxford	oxford 
audition	auditie
obesity	obesitas
athlete	sporter
seawater	zeewater
schizophrenia	schizofrenie
geometry	meetkunde
manganese	mangaan
methylphenidate	methylfenidaat
mediastinum	mediastinum
apoptosis	apoptose
ginsenoside	ginsenoside
vedas	veda's
lesion	laesie
adenoviridae	adenovirussen
glucagonoma	glucagonoom
digoxin	digoxine
vitalism	vitalisme 
tungsten	wolfraam
mesopotamia	mesopotamië
fatigue	fatigue
polycythemia	polycythemie
flea	vlooien
delphinium	ridderspoor 
erasistratus	erasistratos
al-nasa'i	al-nasa'i
ouabain	ouabaïne
viviparity	viviparie
critolaus	kritolaos
hellebore	nieskruid
ectoderm	ectoderm
clomifene	clomifeen
charité	charité 
tularemia	tularemie
spirometry	spirometrie
elisa	elisa
liquid	vloeistof
peppermint	pepermunt 
cyprus	cyprus
conservatorship	curatele 
lipid	lipide
hypochondriasis	hypochondrie
edema	oedeem
dietitian	diëtist
biopharmaceutical	biological
flora 	flora 
latex	latex
nuremberg	neurenberg
rutherford 	rutherford 
emphysema	emfyseem
megara	megara 
thioacetamide	thioaceetamide
mood 	gemoedstoestand
syrup	stroop
trout	forel 
plastid	plastide
caregiver	mantelzorg
abatacept	abatacept
pyrolysis	pyrolyse
twin	tweeling 
medicalization	medicalisatie
contextualism	contextualisme 
citrus	citrus 
nicotine	nicotine
mdma	mdma
monomethylhydrazine	methylhydrazine
dominance 	dominant 
acrylamide	acrylamide
spectrometer	spectrometer
politico	politico
plasmid	plasmide
exercise	lichaamsbeweging
deficiency 	deficiëntie 
tyramine	tyramine
gossypol	gossypol
anesthesiology	anesthesiologie
kyphoscoliosis	kyfoscoliose
eukaryote	eukaryoten
hydrophobe	hydrofoob
cobalt-60	kobalt-60
lung	long 
botulism	botulisme
ketene	keteen
methamphetamine	methamfetamine
gastroenteritis	buikgriep
sucrose	sacharose
malnutrition	malnutritie
jiangxi	jiangxi
glycoside	glycoside
substrate 	substraat 
kilogram	kilogram
cofactor 	cofactor 
serositis	serositis
edema	oedeem
gasoline	benzine
ephesus	efeze
verbena	verbena
antifungal	antimycoticum
orgasm	orgasme
melbourne	melbourne
pulse	polsslag
nursing	verpleegkunde
neoplatonism	neoplatonisme
neurosis	neurose
hyperthyroidism	thyreotoxicose
fatigue	fatigue
promiscuity	promiscuïteit
insulinoma	insulinoom
pregabalin	pregabaline
amnesia	geheugenverlies
asparagine	asparagine
inflammation	ontsteking 
acrocyanosis	acrocyanose
coronavirus	coronavirussen
methadone	methadon
alchemy	alchemie
electronvolt	elektronvolt
arrhythmia	hartritmestoornis
shaucha	shaucha
pear	peer 
triclosan	triclosan
anthelmintic	anthelminthica
piperine	piperine
stomach	maag
pulmonology	pulmonologie
quercetin	quercetine
consciousness	bewustzijn
calcitonin	calcitonine
swimming 	zwemsport
compassion	medelijden
ventilator	beademingsapparaat
neoplasm	neoplasie
kava	kava 
hedonism	hedonisme
alicudi	alicudi
trichloroethylene	trichlooretheen
naturalism 	naturalisme 
vertebra	wervel 
empúries	empúries
mollusca	weekdieren
1,1,1-trichloroethane	1,1,1-trichloorethaan
gastroparesis	gastroparese
gynecomastia	gynaecomastie
paleolithic	paleolithicum
theophylline	theofylline
candida 	candida 
botany	plantkunde
pneumothorax	pneumothorax
durga	durga
chrysopoeia	chrysopoeia
gilbert 	gilbert 
lyceum 	lykeion
nephritis	nefritis
taxidermy	taxidermie
nitrox	nitrox
almond	amandelboom
cauterization	cauterisatie
phalanx	falanx
advocaat	advocaat 
scrapie	scrapie
infliximab	infliximab
kilogram	kilogram
paracetamol	paracetamol
enzyme	enzym
frequency	frequentie
facsimile	facsimile
cardioversion	cardioversie
histology	histologie
radiography	röntgenfoto
reinforcement	bekrachtiging
statistic	steekproeffunctie
rheumatism	reuma
europium	europium
poultry	pluimvee
yajna	yajna
dahae	dahae
porphyria	porfyrie
amnion	amnion
lamotrigine	lamotrigine
vasodilation	vasodilatatie
spleen	milt
ivacaftor	ivacaftor
angiotensin	angiotensine
adhesive	lijm
saffron	saffraan
parent	ouder
lactitol	lactitol
lawrencium	lawrencium
micrometre	micrometer 
infection	infectie
salt	keukenzout
erythromycin	erytromycine
glycoside	glycoside
dermis	dermis
india	india
heart	hart
berylliosis	berylliose
osteochondrosis	osteochondrose
hypnosis	hypnose
zmapp	zmapp
puranas	purana's
tamsulosin	tamsulosine
mesna	mesna
thrombin	trombine
mathematician	wiskundige
nephron	nefron
chinois	chinois 
c-peptide	c-peptide
carboxyhemoglobin	carboxyhemoglobine
bronchitis	bronchitis
virus	virus 
prayer	gebed
yunnan	yunnan
echocardiography	echocardiografie
myosin	myosine
p 	p 
magnetometer	magnetometer
chrysolina	chrysolina
petal	kroonblad
dissociation 	dissociatie 
bupropion	bupropion
centrosome	centrosoom
cyclophosphamide	cyclofosfamide
bee	bijen
saccharomyces	saccharomyces
ap1000	ap1000-reactor
verapamil	verapamil
eurobarometer	eurobarometer
photogram	fotogram
gametogenesis	gametogenese
trichophagia	trichofagie
psilocin	psilocine
coccidioidomycosis	coccidioidomycose
anemia	bloedarmoede
tentacle	tentakel
polygyny	polygynie
orchitis	orchitis
endocardium	endocard
aztecs	azteken
hepatocyte	hepatocyt
hypokalemia	hypokaliëmie
levetiracetam	levetiracetam
calcification	calcificatie
darmstadtium	darmstadtium
steroid	steroïde
zuclopenthixol	zuclopentixol
biophysics	biofysica
zeolite	zeoliet
alkaloid	alkaloïde
syngnathidae	syngnathidae
anemia	bloedarmoede
warthog	phacochoerus
proteinuria	proteïnurie
liraglutide	liraglutide
seizure	insult
physics 	fysica 
orthopnea	orthopneu
cirrhosis	cirrose
rad 	rad 
perspiration	zweten
christians	christen
microfilament	microfilament
permian	perm 
heredity	erfelijkheid
sodium	natrium
pus	pus
alcoholism	alcoholisme
burn	brandwond
ventricle 	ventrikel 
hospice	hospice
saraswati	sarasvati 
seizure	insult
indigestion	dyspepsie
sinusitis	bijholteontsteking
copper	koper 
ouroboros	ouroboros
taste	smaakzin
infarction	infarct
electronvolt	elektronvolt
rama	rama
melioidosis	melioidose
buoyancy	drijfkracht
ciclosporin	ciclosporine
digoxin	digoxine
bradycardia	bradycardie
tantalum	tantaal
optometry	optometrie
loganiaceae	loganiaceae
medicine	geneeskunde
calorie	calorie
epidemiology	epidemiologie
athetosis	athetose
lecithin	lecithine
sprint 	sprint 
violet 	violet
brca1	brca1
scotland	schotland
alkali	alkali
subspecies	ondersoort
edema	oedeem
technology	technologie
terbinafine	terbinafine
methylphenidate	methylfenidaat
questionnaire	vragenlijst
korčula	korčula 
malathion	malathion
paint	verf
vis 	vis 
fibrosis	fibrose
agomelatine	agomelatine
apitherapy	apitherapie
cryonics	cryonisme
fibroblast	fibroblast
aristotle	aristoteles
icd-10	icd-10
lung	long 
bleeding	bloeding
phosphorescence	fosforescentie
baclofen	baclofen
alcoholism	alcoholisme
capillary	haarvat
bacteria	bacteriën
bulgaria	bulgarije
rhodes	rhodos 
zoonosis	zoönose
sita	sita 
hyperthyroidism	thyreotoxicose
sacrum	heiligbeen
hydralazine	hydralazine
fine 	boete
azhdarchoidea	azhdarchoidea
panthenol	panthenol
anaximander	anaximander
mashing	maischen
streptococcus	streptokokken
docusate	natriumdioctylsulfosuccinaat
oxalate	oxalaat
ustekinumab	ustekinumab
beer	bier
malnutrition	malnutritie
glycosuria	glucosurie
chelation	chelatie
kinase	kinase
sake	sake
mutation	mutatie 
methylcobalamin	methylcobalamine
mometasone	mometasonfuroaat
mamba	mamba's
valproate	valproïnezuur
deuterium	deuterium
hyponatremia	hyponatriëmie
arthralgia	artralgie
pinworm 	aarsmade
lysosome	lysosoom
flumazenil	flumazenil
physicalism	fysicalisme
benzophenone	benzofenon
śruti	shruti
golf	golf 
inflammation	ontsteking 
taoism	taoïsme
symporter	symporter
lutetium	lutetium
concrete	beton
benin	benin
paracelsus	paracelsus
fibroma	fibroom
hyperventilation	hyperventilatie
mptp	mptp
palpation	palpatie
vegetotherapy	vegetotherapie
behaviorism	behaviorisme
neoplasm	neoplasie
sesquioxide	sesquioxide
defibrillation	defibrillatie
vein	ader 
aspergillosis	aspergillose
tulsidas	tulsidas
menopause	menopauze
diatom	diatomeeën
zuclopenthixol	zuclopentixol
pimozide	pimozide
tomography	tomografie
lahore	lahore
julienning	julienne 
pericardium	pericard
biomechanics	biomechanica
yajurveda	yajoerveda
lysis	lyse
nerve	zenuw
macrocephaly	macrocefalie
emtricitabine	emtricitabine
2c-i	2c-i
cannula	canule 
systole	systole 
prevalence	prevalentie
valence 	valentie 
teratoma	teratoom
civitas	civitas
celery	selderij
cannula	canule 
synapse	synaps
polysomnography	polysomnografie
cytokine	cytokine
cicutoxin	cicutoxine
placebo	placebo 
rhinoceros	neushoorns
calibration	kalibreren
annelid	ringwormen
cholecalciferol	cholecalciferol
craniotomy	craniotomie
triglyceride	triacylglycerol
masterpiece	meesterwerk
lycurgus 	lycurgus 
sclera	sclera
electrolyte	elektrolyt
electrocardiography	elektrocardiogram
lung	long 
azotemia	azotemie
hemocyanin	hemocyanine
pakistan	pakistan
generation	generatie 
valve	ventiel 
affect 	affect
electrolyte	elektrolyt
x-ray	röntgenstraling
malaise	malaise
axolotl	axolotl
hormesis	hormese
uranium	uranium
broadband	breedband
metamizole	metamizol
prokaryote	prokaryoten
scabies	schurft 
tamsulosin	tamsulosine
etanercept	etanercept
vaccination	inenting
ultraviolet	ultraviolet
ebola	ebola
hydroperoxyl	waterstofsuperoxide
erythropoiesis	erytropoëse
lanthanide	lanthanide
transmittance	transmissie 
ubiquitin	ubiquitine
schistosoma	schistosoma
endorphins	endorfine
carboxylate	carboxylaatgroep
cauterization	cauterisatie
z-test	z-toets
aromatase	aromatase
suspension 	suspensie 
scalp	hoofdhuid
catabolism	katabolisme
ibm	ibm
litre	liter
strain 	stam 
cypermethrin	cypermetrine
nitrile	nitril
atlas 	atlas 
ergine	ergine
fatigue	fatigue
kallawaya	kallawaya
coma	coma 
esophagogastroduodenoscopy	gastroscopie
hypotension	hypotensie
phosphate	fosfaat
tachypnea	tachypnoe
optimism	optimisme
caribbean	caraïben
ischemia	ischemie
sacrum	heiligbeen
salbutamol	salbutamol
genus	geslacht 
flood	overstroming
brunei	brunei
gabapentin	gabapentine
nucleotide	nucleotide
fahrenheit	fahrenheit
hangover	kater 
self-awareness	zelfbewustzijn
garden	tuin
chemotherapy	chemotherapie
duck	eenden
bronchus	luchtpijpvertakking
cryptanalysis	cryptoanalyse
demography	demografie
insulin 	insulinetherapie
production 	productie
warfarin	warfarine
sambo 	sambo
louse	dierluizen
clonidine	clonidine
somalia	somalië
colophon 	colophon
gallstone	galsteen
lacosamide	lacosamide
fructosamine	fructosamine
protamine	protamine
vulcano	vulcano 
obesity	obesitas
particle	deeltje
pride	trots
sacrum	heiligbeen
heart	hart
carcinoma	carcinoom
sedative	sedativum
witherite	witheriet
firocoxib	firocoxib
hospital	ziekenhuis
respirator	ademhalingsbeschermingsmasker
electrolyte	elektrolyt
maintenance 	onderhoud
tafluprost	tafluprost
taoism	taoïsme
diagnosis	diagnose
reduction 	reduceren 
amyloidosis	amyloïdose
cervix	baarmoederhals
forearm	onderarm
1,1,1-trichloroethane	1,1,1-trichloorethaan
constipation	constipatie
moclobemide	moclobemide
lithium 	lithium 
tetracycline	tetracycline
śrauta	shrauta
calorie	calorie
particulates	fijnstof
coccyx	stuit
charaka	charaka
rudaki	rudaki
superphénix	superphénix
acetanilide	acetanilide
dismemberment	vierendeling
phonophobia	fonofobie
cardiomyopathy	cardiomyopathie
unesco	unesco
polycarbonate	polycarbonaat
lambert 	lambert 
encoding 	inprenting 
reptile	reptielen
hermaphrodite	tweeslachtigheid
pravastatin	pravastatine
uniformitarianism	uniformitarianisme
midazolam	midazolam
tracheotomy	tracheotomie
medtronic	medtronic
ramlila	ramlila
millisecond	milliseconde
calabria	calabrië
splenomegaly	splenomegalie
allergy	allergie
proteolysis	proteolyse
iminium	iminium
bilirubin	bilirubine
maggot	made 
interdisciplinarity	interdisciplinariteit
reinforcement	bekrachtiging
saxony	saksen 
liver	lever
cachexia	cachexie
physiology	fysiologie
photometer	lichtmeter
amlodipine	amlodipine
chives	bieslook
atrium 	atrium 
hematology	hematologie
trachea	luchtpijp
acromegaly	acromegalie
jellyfish	kwallen
imagination	verbeeldingskracht
tablet 	tablet
syndrome 	syndrome
antibody	immunoglobuline
rumen	pens
pethidine	pethidine
blackburn	blackburn 
breastfeeding	borstvoeding
carcinogen	carcinogeen
biotechnology	biotechnologie
phosphorylation	fosforylering
qiyan	qiyan
switzerland	zwitserland
glycolonitrile	glycolnitril
vasodilation	vasodilatatie
cocaine	cocaïne
pulmonology	pulmonologie
skutterudite	skutterudiet
stethoscope	stethoscoop
unicum	unicum 
milan	milaan 
radionuclide	radionuclide
polio	poliomyelitis
pontefract	pontefract
finswimming	vinzwemmen
devi	devi 
disulfiram	disulfiram
volunteering	vrijwilligerswerk
7-dehydrocholesterol	7-dehydrocholesterol
medicine	geneeskunde
cider	cider
nirvana 	nirvana 
aquifer	aquifer
pathogen	pathogeen
memory	geheugen 
pyrrolidine	pyrrolidine
acetone	aceton
baghdad	bagdad
bedale	bedale
hermetica	hermetica
abc 	abcde-methode
solidarity	solidariteit 
asclepeion	asklepieion
humorism	humores
craniotomy	craniotomie
hyperuricemia	hyperurikemie
arachnid	spinachtigen
vegetable	groente
potassium	kalium
maryland	maryland
neurology	neurologie
hippocras	hipocras
eggnog	eggnog
misoprostol	misoprostol
stenosis	stenose
simvastatin	simvastatine
giresun	giresun 
superfood	superfood
glycyrrhizin	glycyrrizinezuur
tachycardia	tachycardie
microscopy	microscopie
spironolactone	spironolacton
polyphenol	polyfenol
pessimism	pessimisme
fluorescence	fluorescentie
eponym	eponiem
photodermatitis	fotocontactallergie
routledge	routledge 
diltiazem	diltiazem
propiverine	propiverine
levofloxacin	levofloxacine
pubchem	pubchem
hemoglobin	hemoglobine
amitraz	amitraz
himalayas	himalaya
mifepristone	mifepriston
clitellata	clitellata
afamelanotide	afamelanotide
halite	haliet
americas	amerika 
kinshasa	kinshasa
coagulopathy	stollingsstoornis
capecitabine	capecitabine
pneumonia	longontsteking
medicare 	medicare
acetonitrile	acetonitril
bayer	bayer
health	gezondheid
mylan	mylan
nantes	nantes
brucine	brucine
fish	vissen 
neurotransmitter	neurotransmitters
évian-les-bains	évian-les-bains
himera	himera
benzothiazole	benzothiazool
chickenpox	waterpokken
mahabharata	mahabharata
phoenicia	fenicië
tsipouro	tsipouro
akrai	akrai
vertigo	draaiduizeligheid
edema	oedeem
knidos	cnidus
infarction	infarct
louvre	louvre
biomimetics	biomimetica
hypocapnia	hypocapnie
monocyte	monocyt
14-methoxymetopon	14-methoxymetopon
detonation	detonatie
fairphone	fairphone
amgen	amgen
contentment	tevredenheid
diltiazem	diltiazem
dosha	dosha
insect	insecten
cryptosporidium	cryptosporidium
edema	oedeem
etoglucid	tri-ethyleenglycoldiglycidylether
carbenoxolone	carbenoxolon
anuradhapura	anuradhapura 
phenytoin	fenytoïne
marzipan	marsepein
cellulitis	cellulitis 
socrates	socrates 
flux 	flux 
vitruvius	vitruvius 
sensodyne	sensodyne
troponin	troponine
yorkshire	yorkshire
particulates	fijnstof
hamartoma	hamartoom
christianity	christendom
erythropoietin	erytropoëtine
al-sijzi	al-sijzi
ciclosporin	ciclosporine
business	bedrijf
pneumonia	longontsteking
tauopathy	tauopathie
joule	joule
nerve	zenuw
fever	koorts
insulin	insuline
hospital	ziekenhuis
apathy	apathie
bilirubin	bilirubine
coelom	coeloom
lecce	lecce 
kainite	kaïniet
inhalation	inademing
wikiversity	wikiversity
francium	francium
bohrium	bohrium
jupiter 	jupiter 
acceleration	versnelling 
invertebrate	ongewervelden
pramana	pramana
catfish	meervalachtigen
chemistry	scheikunde
holi	holi-phagwa
openehr	openehr
dysarthria	dysartrie
raltegravir	raltegravir
object 	object 
epitestosterone	epitestosteron
miosis	miose
stellarator	stellarator
orthomyxoviridae	orthomyxoviridae
fungus	schimmels
gallbladder	galblaas
probiotic	probioticum
topology	topologie
ester	ester 
vaishnavism	vaishnavisme
heart 	heart
frog	kikkers
cryoglobulinemia	cryoglobulinemie
copperbelt	kopergordel
hypertension	hypertensie
coagulation	bloedstolling
perspiration	zweten
epithelium	epitheel
asphyxia	verstikking
esophagogastroduodenoscopy	gastroscopie
coagulase	coagulase
tetraodontidae	kogelvissen
kerala	kerala
roehampton	roehampton
heart 	heart 
joule	joule
echinococcosis	echinokokkose
praxiteles	praxiteles
prussia	pruisen
montelukast	montelukast
lung	long 
hectare	hectare
ligand 	ligand 
atheroma	plaque 
cryotherapy	cryotherapie
piritramide	piritramide
theobromine	theobromine
donepezil	donepezil
turbidity	troebelheid
puruṣārtha	purushartha
ladakh	ladakh
tea	thee 
reserpine	reserpine
apoptosis	apoptose
variance	variantie
dermatophyte	dermatofyt
lymphadenopathy	lymfadenopathie
nephrology	nefrologie
carfentanil	carfentanil
chondrichthyes	kraakbeenvissen
scheelite	scheeliet
knee	knie 
ephedra 	ephedra
actin	actine
hexanol	hexanol
famine	hongersnood
diol	diol
comorbidity	comorbiditeit
gastroenteritis	buikgriep
hypertension	hypertensie
antispasmodic	spasmolyticum
pubis 	schaambeen
cigarette	sigaret
vertebra	wervel 
athanor	athanor
oligomenorrhea	oligomenorroe
chromatography	chromatografie
animal	dierenrijk
polymer	polymeer
epaminondas	epaminondas
diastole	diastole 
holmium	holmium
titin	titine
ferdowsi	ferdowsi
hematuria	hematurie
4-methylthioamphetamine	4-methylthioamfetamine
disease	ziekte
etiology	etiologie
peritoneum	buikvlies
paronychia	paronychia
aconitum	monnikskap
shahnameh	sjahnama
homeostasis	homeostase 
martyr	martelaar
sagunto	sagunto
vaccine	vaccin
sweetness	zoet 
extraction 	extractie 
androstenedione	androsteendion
hyperthyroidism	thyreotoxicose
spline 	spline
hyperalgesia	hyperalgesie
glasgow	glasgow
sensitization	sensitisatie
reflex	reflex 
edema	oedeem
methylphenidate	methylfenidaat
melamine	melamine
chloroplast	chloroplast
grog	grog
moxibustion	moxibustie
hypotension	hypotensie
walking	lopen
paracelsus 	paracelsus 
bariatrics	bariatrie
sodalite	sodaliet
gastroenteritis	buikgriep
glucuronidation	glucuronidering
aldehyde	aldehyde
equivalent 	val 
hygiene	hygiëne
papyrus	papyrus 
olanzapine	olanzapine
inotrope	inotropie
prostaglandin	prostaglandinen
ampere	ampère 
irbesartan	irbesartan
halal	halal
osteoarthritis	artrose
mammography	mammogram
enema	klysma
isoleucine	isoleucine
astronomy	astronomie
denver	denver
oviparity	oviparie
biomarker	biomarker
confusion	verwardheid
al-farabi	al-farabi
maitotoxin	maitotoxine
iphone	iphone
khwarazm	chorasmië
pericarditis	pericarditis
abulia	aboulie
hypoglycemia	hypoglykemie
histone	histon 
enzyme	enzym
urology	urologie
brahmana	brahmana 
group 	groep 
hydrostatics	hydrostatica
weakness	asthenie
cognac	cognac 
saponification	verzeping
phenytoin	fenytoïne
humiliation	vernedering
graphene	grafeen
otorhinolaryngology	otorinolaryngologie
prolactinoma	prolactinoom
electromagnetism	elektromagnetisme
chop 	chop
pharmacovigilance	medicatiebewaking
bacchylides	bacchylides
mittelschmerz	mittelschmerz
cannabinoid	cannabinoïde
drama 	dramafilm
carbamazepine	carbamazepine
onion	ui 
clobazam	clobazam
lymphangioleiomyomatosis	lymfangioleiomyomatose
gas	gas 
sappho	sappho
calcinosis	calcinose
almagest	almagest
meta-analysis	meta-analyse
glass	glas
magnetite	magnetiet
agranulocyte	agranulocyt
saskatchewan	saskatchewan
gain 	versterkingsfactor
kalanchoe	kalanchoë
microcirculation	microcirculatie
medscape	medscape
gangrene	gangreen
carbuncle	karbonkel 
xenopus	klauwkikkers
stimulant	stimulantia
glycolysis	glycolyse
diarrhea	diarree
statcoulomb	statcoulomb
n,n-dimethyltryptamine	dimethyltryptamine
sound	geluid
astringent	adstringentia
ephedra 	ephedra
coagulation	bloedstolling
caduceus	caduceus
guṇa	guna 
entheogen	entheogeen
lenzie	lenzie
aljaraque	aljaraque
cardiology	cardiologie
suda	suda
noscapine	noscapine
epithelium	epitheel
ptosis 	ptose 
checklist	checklist 
chromatin	chromatine
hunan	hunan
drag 	stromingsweerstand
β-carotene	bètacaroteen
glycoside	glycoside
cuvette	cuvet
myocarditis	myocarditis
retrovirus	retrovirussen
humorism	humores
parkinsonism	parkinsonisme
indigestion	dyspepsie
alprazolam	alprazolam
gynecomastia	gynaecomastie
nocardia	nocardia
brahma	brahma 
particulates	fijnstof
narcotic	drug
angiotensin	angiotensine
cholesterol	cholesterol
disease	ziekte
myocarditis	myocarditis
tolnaftate	tolnaftaat
stridor	stridor
particulates	fijnstof
hemodynamics	hemodynamiek
antifungal	antimycoticum
amphoterism	amfoteer
medication	geneesmiddel
behavior	gedrag
tritium	tritium
graph 	graaf 
dissection 	dissectie 
thessaly	thessalië
melusine	melusine
neptunite	neptuniet
acceptance	aanvaarding
kilogram	kilogram
apollonia 	apollonia 
kyōgen	kyogen
keloid	keloïd
1,4-thiazepine	1,4-thiazepine
gravity	zwaartekracht
diphtheria	difterie
asana	asana
cholecystitis	cholecystitis
hermetica	hermetica
inositol	inositol
unisys	unisys
resource	bestaansmiddelen
wilderness	wildernis 
dextran	dextraan
leucine	leucine
ddt	dichloordifenyltrichloorethaan
indication 	indicatie 
tofu	tofoe
vermouth	vermout
ergine	ergine
üsküdar	üsküdar
coolant	koelmiddel
scabies	schurft 
fexofenadine	fexofenadine
taste	smaakzin
tripelennamine	tripelennamine
psoriasis	psoriasis
auscultation	auscultatie
fibrinogen	fibrinogeen
fabaceae	vlinderbloemenfamilie
hemolithin	hemolithine
antibiotic	antibioticum
soju	soju
biofilm	biofilm
ventricle 	ventrikel 
crayfish	rivierkreeften
monosomy	monosomie
primate	primaten
poaching	wildstroperij
otorhinolaryngology	otorinolaryngologie
shoulder	schouder
hyperglycemia	hyperglykemie
lycoris 	lycoris 
lung	long 
bremsstrahlung	remstraling
chersonesus	chersonesos 
furazolidone	furazolidon
percentile	percentiel
schwaz	schwaz 
strychnine	strychnine
hives	netelroos
glycogenolysis	glycogenolyse
bronchus	luchtpijpvertakking
axon	axon
microsleep	microslaap
liposuction	liposuctie
chlorprothixene	chloorprotixeen
erysipeloid	erysipeloid
dextromethorphan	dextromethorfan
endosulfan	endosulfan
psychonautics	psychonaut
domperidone	domperidon
testosterone	testosteron
esophagus	slokdarm
mountain	berg 
computability	berekenbaarheid
minoxidil	minoxidil
digitalis	vingerhoedskruid 
parmenides	parmenides
gais	gais 
śramaṇa	shramanisme
lactose	lactose
morus 	moerbei
coevolution	co-evolutie
fibromyalgia	fibromyalgie
cobalt	kobalt
vertebra	wervel 
limb 	ledemaat
abscess	abces
arrhythmia	hartritmestoornis
apollonia 	apollonia 
ear	oor
finswimming	vinzwemmen
feeling	gevoel
tampon	tampon 
flemish	vlaams
medicine	geneeskunde
profiling 	profiler
rainforest	regenwoud
aluminium	aluminium
science	wetenschap
serum 	serum
menthol	menthol
hemoglobin	hemoglobine
sacrum	heiligbeen
envy	nijd
troponin	troponine
agonist	agonist 
renaissance	renaissance
acid	zuur 
biotite	biotiet
auscultation	auscultatie
anise	anijs
shiatsu	shiatsu
ulm	ulm 
neutropenia	neutropenie
methamphetamine	methamfetamine
author	auteur
odor	geur
osteosarcoma	osteosarcoom
nonmetal	niet-metaal
5-meo-dmt	5-meo-dmt
dynamite	dynamiet
exhalation	uitademing
numerology	numerologie
batumi	batoemi
pythagoras	pythagoras
dell	dell
oxidase	oxidase
nephron	nefron
piroxicam	piroxicam
mephedrone	mefedron
monogamy	monogamie
acetyl-coa	acetyl-coa
terbium	terbium
polysaccharide	polysacharide
hesy-ra	hesire
ranolazine	ranolazine
nicander	nicander
hinduism	hindoeïsme
lipophilicity	lipofiel
hypertrichosis	hypertrichose
oseltamivir	oseltamivir
laboratory	laboratorium
hyperhomocysteinemia	hyperhomocysteïnemie
moon	maan
dextran	dextraan
ultraviolet	ultraviolet
hyperammonemia	hyperammoniëmie
commandaria	commandaria
ventricle 	ventrikel 
sharia	sharia
solubility	oplosbaarheid
lung	long 
epirus 	epirus 
contracture	contractuur 
aesthetics	esthetica
primer 	primer 
hand	hand
gnome	kabouter
babesiosis	babesiosis
gallbladder	galblaas
japan	japan
speech	spraak
allotropy	allotropie
stegosaurus	stegosaurus
determinism	determinisme 
ligand 	ligand 
micronutrient	micronutriënt
tolterodine	tolterodine
prosecco	prosecco
dizziness	duizeligheid
micrometre	micrometer 
anastomosis	anastomose
eleusis	elefsina
vedas	veda's
epiglottitis	epiglottitis
bifidobacterium	bifidobacterium
biopolymer	biopolymeer
cancer	kanker
encephalopathy	encefalopathie
epithelium	epitheel
pyridoxine	pyridoxine
ketamine	ketamine
vedanta	vedanta
weltschmerz	weltschmerz
kashrut	kasjroet
zygote	zygote
hospital	ziekenhuis
kama	kama 
arrhythmia	hartritmestoornis
lansoprazole	lansoprazol
cardiolipin	cardiolipine
kalam	kalam 
toxin	toxine
receptor 	receptor 
elf	elf 
shandy	shandy
antioxidant	antioxidant
wavenumber	golfgetal
cardiology	cardiologie
adrenaline	adrenaline
barnidipine	barnidipine
arsenate	arsenaat
epithelium	epitheel
rage 	razernij
speakeasy	speakeasy
pergamon	pergamon
hydrography	hydrografie
5α-reductase	5-alfa-reductase
actinomycetota	straalzwammen
barotrauma	barotrauma
cirrhosis	cirrose
deoxyribose	desoxyribose
avicenna	avicenna
chess	schaken
colonisation 	kolonisatie 
hypovolemia	hypovolemie
confusion	verwardheid
endomysium	endomysium
virilization	virilisatie
perry	perenwijn
procaine	procaïne
arm	arm 
aplysia	aplysia
halogen	halogeen
neurotensin	neurotensine
wound	wond
thoracentesis	pleurapunctie
cytogenetics	cytogenetica
yellow-tail	donsvlinder
hashish	hasjiesj
safranin	safranine
cartilage	kraakbeen
fear	angst
diffraction	diffractie
bradykinin	bradykinine
sugilite	sugiliet
treponema	treponema
hermetica	hermetica
methylnaltrexone	methylnaltrexon
atlas 	atlas 
genistein	genisteïne
pleasure	genot
glycoside	glycoside
pope	paus
stipule	steunblaadje
dutasteride	dutasteride
malabsorption	malabsorptie
pneumonectomy	pneumectomie
therapy	therapie
fungus	schimmels
gynaecology	gynaecologie
alembic	alambiek
al-biruni	al-biruni
ftsz	ftsz
pediatrics	pediatrie
thesis	scriptie
soil	bodem
pottery	pottenbakken
fibroblast	fibroblast
ayurveda	ayurveda
calvados	calvados 
lithium 	lithiumtherapie
sutra	soetra
reading	lezen
sclerosis 	sclerose
fascia	fascie 
solution 	oplossing 
hydrogen	waterstof 
cilium	trilhaar
pittsburgh	pittsburgh
philadelphia	philadelphia 
diethylstilbestrol	di-ethylstilbestrol
tremie	betonkubel
bruise	kneuzing
spirometry	spirometrie
epithelium	epitheel
apeldoorn	apeldoorn 
entrez	entrez
delusion	waan
serology	serologie
arrhythmia	hartritmestoornis
cava 	cava
england	engeland
burial	begrafenis
triazole	triazool
hypotonia	spierhypotonie
metformin	metformine
germany	duitsland
humorism	humores
food	levensmiddel
statin	statine
bronchodilatation	bronchodilatatie
contract	overeenkomst 
ascites	ascites 
woodcut	houtsnede
2,3,7,8-tetrachlorodibenzodioxin	2,3,7,8-tetrachloordibenzo-p-dioxine
honey	honing
nauka 	naoeka 
arsphenamine	arsfenamine
dream	droom
riboflavin	riboflavine
procymidone	procymidon
astrochemistry	astrochemie
electrophysiology	elektrofysiologie
missionary	missionaris
adoration	aanbidding
covid-19	covid-19
carbon-14	koolstof-14
paronychia	paronychia
electromagnet	elektromagneet
loneliness	eenzaamheid
myofibril	myofibril
delusion	waan
anesthetic	anesthetica
emphysema	emfyseem
mdma	mdma
drop 	druppel
bile	gal 
eflornithine	eflornithine
snooker	snooker
catastrophism	catastrofisme
astrology	astrologie
hypertension	hypertensie
tetraethyllead	tetra-ethyllood
grappa	grappa 
spider	spinnen 
smartphone	smartphone
antifungal	antimycoticum
oocyte	oöcyt
cyrenaica	cyrenaica
euphoria	euforie
corticosteroid	corticosteroïden
follicle 	kokervrucht
israel	israël
shiva	shiva
font	lettertype
desalination	ontziltingsinstallatie
irrigation	irrigatie
bacillota	firmicutes
systole	systole 
becquerel	becquerel 
herrerasaurus	herrerasaurus
crispr	crispr
well	waterput
emphysema	emfyseem
rhizome	wortelstok
apocynaceae	maagdenpalmfamilie
tongba	tongba
sugar	tafelsuiker
rectum	endeldarm
flower	bloem 
hypnotherapy	hypnotherapie
tønsberg	tønsberg
speculum 	speculum 
temozolomide	temozolomide
audition	auditie
nocardiosis	nocardiose
xanthine	xanthine
translation 	translatie 
banana	banaan 
leech	bloedzuigers
thrombolysis	trombolyse
morocco	marokko
palygorskite	palygorskiet
cristobalite	cristobaliet
sherry	sherry
aminoglycoside	aminoglycosiden
hexokinase	hexokinase
phosphate	fosfaat
qazvin	qazvin
tampere	tampere
soundscape	geluidslandschap
ddt	dichloordifenyltrichloorethaan
realgar	realgaar
citalopram	citalopram
parecoxib	parecoxib
vadouvan	vadouvan
svādhyāya	svadhyaya
ejaculation	ejaculatie 
kemi	kemi
sarcomere	sarcomeer
pigment	pigment
phlebitis	flebitis
fulcanelli	fulcanelli
indometacin	indometacine
alkylphenol	alkylfenol
echocardiography	echocardiografie
dharmaśāstra	dharmashastra
bronchus	luchtpijpvertakking
mayor	burgemeester
choline	choline
insect	insecten
agonist	agonist 
pericardium	pericard
amphetamine	amfetamine
lung	long 
parasitism	parasitisme
phase 	fase 
oxindole	oxindool
datura	datura
antofagasta	antofagasta 
kazakhstan	kazachstan
wart	wrat
euphoria	euforie
inequality 	ongelijkheid 
funeral	uitvaart
xylometazoline	xylometazoline
veratrum	veratrum
hyphema	hyfeem
tacrolimus	tacrolimus
menopause	menopauze
shaivism	shaivisme
solution 	oplossing 
xerostomia	xerostomie
cytopathology	cytopathologie
lobectomy	lobectomie
cobalt	kobalt
lepidolite	lepidoliet
median	mediaan 
hirudin	hirudine
linuron	linuron
neptunium	neptunium
leukotriene	leukotrieen
osteichthyes	beenvisachtigen
wildfire	natuurbrand
embolism	embolie
polis	polis 
allergen	allergeen
spain	spanje
d-dimer	d-dimeer
al-andalus	al-andalus
oophorectomy	oöforectomie
dysdiadochokinesia	dysdiadochokinese
guinea-bissau	guinee-bissau
macrophage	macrofaag
eardrum	trommelvlies
deafblindness	doofblindheid
procaine	procaïne
diet 	dieet
morphogenesis	morfogenese
nucleobase	nucleobase
iloprost	iloprost
charvaka	charvaka
bronchus	luchtpijpvertakking
groundwater	grondwater
ergocalciferol	ergocalciferol
geography	aardrijkskunde
asthma	astma
statin	statine
pinocytosis	pinocytose
ushas	ushas
atrium 	atrium 
antipsychotic	antipsychotica
papaverine	papaverine
vaccine	vaccin
paralanguage	parataal
chacha 	tsjatsja
peach	perzik
cardiomyopathy	cardiomyopathie
retina	netvlies
cocaine	cocaïne
breathalyzer	blaasapparaat
vertebra	wervel 
prosopagnosia	prosopagnosie
rheumatism	reuma
mastic 	mastiek 
algebra	algebra
neoplasm	neoplasie
homocysteine	homocysteïne
sassafras	sassafras
dolasetron	dolasetron
taoism	taoïsme
acetazolamide	acetazolamide
syphilis	syfilis
bleeding	bloeding
embryo	embryo
tetrapod	viervoeters 
satay	saté
shinkansen	shinkansen
acrylonitrile	acrylonitril
heliaia	heliaia
nicotine	nicotine
encopresis	encoprese
archilochus	archilochus 
salou	salou
hyponatremia	hyponatriëmie
aeroponics	aerocultuur
endoderm	endoderm
xanthine	xanthine
estriol	oestriol
bathyscaphe	bathyscaaf
clindamycin	clindamycine
nutrient	voedingsstof
antifungal	antimycoticum
cachaça	cachaça
carbachol	carbachol
neuroscience	neurowetenschap
adult	volwassene
lymphedema	lymfoedeem
oogenesis	oögenese
endurance	uithoudingsvermogen
suffix	suffix
microvillus	microvillus
confusion	verwardheid
acne	acne
thimble	vingerhoed
endocarditis	endocarditis
cirrhosis	cirrose
eucestoda	eucestoda
theanine	theanine
ünye	ünye 
coca-cola	coca-cola
fondaparinux	fondaparinux
rotavirus	rotavirus
x-ray 	x-ray
steel	staal 
carbapenem	carbapenem
chocolate	chocolade
reflex	reflex 
almshouse	godshuis
rodent	knaagdieren
atheroma	plaque 
brahmacharya	brahmacharya
bitters	bittertje
bevacizumab	bevacizumab
alcohol 	alcohol 
infant	baby
pericardium	pericard
anuria	anurie
aristotelianism	aristotelisme
papaver	klaproos
gastrinoma	gastrinoom
inhalant	lijmsnuiven
scurvy	scheurbuik
spondyloarthropathy	spondylartropathie
phthalate	ftalaat
amlodipine	amlodipine
echo	echo 
sciacca	sciacca
injury	verwonding
meninges	hersenvliezen
myocarditis	myocarditis
imhotep	imhotep
infant	baby
tissue 	weefsel 
ritonavir	ritonavir
particulates	fijnstof
d-dimer	d-dimeer
methane	methaan
beef	rundvlees
dasatinib	dasatinib
sarcoplasm	sarcoplasma
muscovite	muscoviet
bilateria	bilateria
botswana	botswana
aorta	aorta
ibuprofen	ibuprofen
phospholipid	fosfolipide
reiki	reiki
thrombosis	trombose
ventricle 	ventrikel 
yellow	geel 
digitalis	vingerhoedskruid 
angiotensin	angiotensine
neurochip	neurochip
autolysis 	autolyse
retrovirus	retrovirussen
pericardium	pericard
valence 	valentie 
asterids	asterids
comorbidity	comorbiditeit
heredity	erfelijkheid
myosin	myosine
segesta	segesta 
melanoma	melanoom
phenothrin	fenothrine
cocktail	cocktail
mediastinoscopy	mediastinoscopie
artemis	artemis 
chloralose	alfachloralose
ligament	ligament 
artery	slagader
ireland	ierland 
penicillin	penicilline
demography	demografie
hermeticism	hermetisme
hypothermia	hypothermie
prostaglandin	prostaglandinen
half-life	halveringstijd
organ 	orgaan
acridine	acridine
self-actualization	zelfactualisering
reproducibility	reproduceerbaarheid
reptile	reptielen
parenchyma	parenchym 
vanadium	vanadium
dictyostelium	dictyostelium
thermoplastic	thermoplast
asplenia	asplenie
embolization	embolisatie
norway	noorwegen
amisulpride	amisulpride
erection	erectie
prediction	voorspelling 
mouth	mond 
vegetable	groente
samkhya	samkhya
hypothalamus	hypothalamus
boule 	boulè
cryonics	cryonisme
autopsy	autopsie
ruthenium	ruthenium
hydroxylysine	hydroxylysine
lipoprotein	lipoproteïne
fraction	breuk 
suunto	suunto
carditis	carditis
bank	bank 
labyrinthitis	labyrintitis
nortriptyline	nortriptyline
hindutva	hindoetva
pharmacodynamics	farmacodynamiek
peace	vrede
djibouti	djibouti 
trimethylamine	trimethylamine
telmisartan	telmisartan
prohibition	drooglegging 
psychosis	psychose
vacuole	vacuole
chemometrics	chemometrie
ammonia	ammoniak
schizophrenia	schizofrenie
harpagophytum	duivelsklauw
thyroglobulin	thyreoglobuline
fatigue	fatigue
hydrostatics	hydrostatica
lead	lood 
eukaryote	eukaryoten
leather	leer 
coagulation	bloedstolling
exocytosis	exocytose
scholasticism	scholastiek
exosphere	exosfeer
shock 	shock
sesame	sesam
metirosine	metirosine
needlefish	gepen
transcription 	transcriptie 
adrenochrome	adrenochroom
rationalism	rationalisme
atherosclerosis	atheromatose
meta-communication	metacommunicatie
embolism	embolie
ecclesia 	ekklèsia
endorphins	endorfine
ale	ale 
artemisia 	alsem
slivovitz	slivovitsj
london	londen
prevalence	prevalentie
raceme	tros 
constantinople	constantinopel
ataxia	ataxie
inotrope	inotropie
potassium	kalium
crank 	morosofie
histology	histologie
sonoluminescence	sonoluminescentie
bleeding	bloeding
alcoholism	alcoholisme
ulcer 	zweer
rain	regen 
poppers	poppers
salzburg	salzburg 
spironolactone	spironolacton
picrotoxin	picrotoxine
propaganda	propaganda 
procaine	procaïne
catheter	katheter
hemoptysis	bloedspuwing
guatemala	guatemala
animal	dierenrijk
genus	geslacht 
ground 	aarde 
anti-inflammatory	ontstekingsremmers
jellyfish	kwallen
consolida	ridderspoor 
pneumonia	longontsteking
platelet	bloedplaatje
mysticism	mystiek
elsevier	elsevier 
mirabegron	mirabegron
persians	perzen
orthohantavirus	hantavirus
quinazoline	chinazoline
amblygonite	amblygoniet
apsis	apside
echocardiography	echocardiografie
massage	massage
mitosis	mitose
vomiting	braken 
hemodialysis	hemodialyse
influenza	griep
defecation	defecatie
lead 	lead
erechtheion	erechtheion
utrecht	utrecht 
azathioprine	azathioprine
organ 	orgaan
period 	periode 
lipid	lipide
hydroxyproline	hydroxyproline
electroplating	elektrodepositie
budapest	boedapest
lung	long 
alsace	elzas
rowing 	roeien 
dronabinol	dronabinol
paracelsus	paracelsus
diarrhea	diarree
winemaking	vinificatie
maat	maät
cocaine 	cocaine
electrolyte	elektrolyt
quetiapine	quetiapine
dietitian	diëtist
histopathology	histopathologie
viroid	viroïde
cochrane 	cochrane 
supercentenarian	supereeuweling
āśrama 	ashrama
frankenstein	frankenstein 
mercury 	mercurius 
interhalogen	interhalogeen
tennessine	tennessine
myoglobin	myoglobine
hepatomegaly	hepatomegalie
russia	rusland
angiotensin	angiotensine
etilefrine	etilefrine
randomness	toeval
tissue 	weefsel 
anovulation	anovulatie
bone	bot 
lovastatin	lovastatine
biochemistry	biochemie
sleep	slaap 
ribosome	ribosoom
desmosome	desmosoom
understanding	begrijpen
egyptology	egyptologie
uterus	baarmoeder
interpreter 	interpreter
legionella	legionella
borehole	boorgat
cyclooxygenase	cyclo-oxygenase
kcnj12	kir2.2
scorpion	schorpioenen 
asphyxia	verstikking
dialysis 	dialyse 
acupuncture	acupunctuur
triphenylphosphine	trifenylfosfine
game 	wild
düsseldorf	düsseldorf
ultraviolet	ultraviolet
menopause	menopauze
asclepias	asclepias
welding	lassen
tongue	tong 
alexandria	alexandrië
hawaii	hawaï
vertebra	wervel 
medication	geneesmiddel
rape	verkrachting
polio	poliomyelitis
crimea	krim
therapy	therapie
behaviorism	behaviorisme
cinnarizine	cinnarizine
commensalism	commensalisme
metre	meter
presbycusis	presbyacusis
electrocardiography	elektrocardiogram
rheumatology	reumatologie
transmittance	transmissie 
hypocalcemia	hypocalciëmie
clove	kruidnagel
disease	ziekte
sighthound	windhond
sneeze	niezen
berkelium	berkelium
carbonylation	carbonylering
altitude	hoogte
encephalitis	hersenontsteking
timolol	timolol
electrolysis	elektrolyse
ligand 	ligand 
kidney	nier 
amasra	amasra 
akathisia	acathisie
pixel	pixel
refrigeration	koeltechniek
mass	massa 
armagnac	armagnac 
plasticity 	plasticiteit 
anthrax	miltvuur
ultraviolet	ultraviolet
venipuncture	venapunctie
sternum	borstbeen
turbidimetry	turbidimetrie
sunscreen	zonnebrandcrème
sudan	soedan
glacier	gletsjer
sternum	borstbeen
aviation	luchtvaart
radiology	radiologie
commensurability 	incommensurabiliteit 
androstenedione	androsteendion
apoptosis	apoptose
heart	hart
gunpowder	buskruit
felbamate	felbamaat
togo	togo
antisthenes	antisthenes
tachycardia	tachycardie
vertebra	wervel 
submarine	onderzeeboot
empyema	empyeem
parvati	parvati
coagulopathy	stollingsstoornis
scandium	scandium
petalite	petaliet
leptospirosis	leptospirose
aether 	ether 
addiction	verslaving
heart	hart
anapa	anapa
hemodialysis	hemodialyse
aphrodisiac	afrodisiacum
protozoa	protozoa
stimulant	stimulantia
assassination	aanslag 
patchouli	patchoeli
vertebrate	gewervelden
firmament	firmament 
sushruta	sushruta
substrate 	substraat 
mniotype	mniotype
methylglyoxal	methylglyoxaal
headache	hoofdpijn
syncytium	syncytium
itraconazole	itraconazol
tamarind	tamarinde
hysteria	hysterie
madrasa	madrassa
intention	intentie
statin	statine
inhalation	inademing
thebacon	thebacon
steroid	steroïde
therapy	therapie
hyperparathyroidism	hyperparathyreoïdie
nephrology	nefrologie
hiccup	hik
depolarization	depolarisatie 
micrognathism	micrognathie
rapeseed	koolzaad
rishikesh	rishikesh
tetraplegia	tetraplegie
klebsiella	klebsiella
soil	bodem
half-life	halveringstijd
camptothecin	camptothecine
lager	lager 
anticoagulant	anticoagulantia
self-esteem	eigenwaarde 
aquarium	aquarium
gc-content	gc-gehalte
chalcogen	zuurstofgroep
platelet	bloedplaatje
caffeine	cafeïne
ephor	eforen
diwali	divali
ventricle 	ventrikel 
algorithm	algoritme
ceruloplasmin	ceruloplasmine
cirrhosis	cirrose
argentina	argentinië
weathering	verwering
synergy	synergie
nephelometry 	nefelometrie
hypernatremia	hypernatriëmie
antiserum	antiserum
za'atar	za'atar
nystatin	nystatine
prevalence	prevalentie
shearing 	afschuiving 
angiotensin	angiotensine
cerberus	kerberos 
calcifediol	calcidiol
cyanosis	cyanose
algorithm	algoritme
hyoscyamine	hyoscyamine
cough	hoest
cough	hoest
urine	urine
trichotillomania	trichotillomanie
nausea	misselijkheid
adenoma	adenoom
scoliosis	scoliose
diuretic	diureticum
alkali	alkali
feedback	terugkoppeling
thermistor	thermistor
crotone	crotone 
electrocardiography	elektrocardiogram
phytoestrogen	fyto-oestrogenen
pound 	pond 
sacrum	heiligbeen
smelting	smelten 
resorcinol	resorcinol
heparin	heparine
remscheid	remscheid
hiv/aids	aids
jainism	jaïnisme
diastereomer	diastereomeer
cereal	graan
alchornea	alchornea
chordate	chordadieren
tetrahydrogestrinone	tetrahydrogestrinon
synedrion	synedrion
keratin	keratine
sarcoma	sarcoom
diet 	dieet
cephalopod	inktvissen
candidiasis	candidiasis
airlock	luchtsluis
chlorpromazine	chloorpromazine
promiscuity	promiscuïteit
toothpaste	tandpasta
taormina	taormina
pyrophosphate	pyrofosfaat
radical 	radicaal 
electrophoresis	elektroforese
flexitarianism	flexitarisme
omnivore	omnivoor
alkane	alkaan
thalamus	thalamus
stoicism	stoa
metaxa	metaxa
periphanes	periphanes
osteoporosis	osteoporose
thujone	thujon
angiogenesis	angiogenese
scarification	scarificatie 
naltrexone	naltrexon
cyanobacteria	blauwalgen
temazepam	temazepam
university	universiteit
phloretin	floretine
injection 	injectie 
combinatorics	combinatoriek
pomorie	pomorie
hydrocephalus	hydrocefalus
electrocardiography	elektrocardiogram
diplopia	diplopie
anisocytosis	anisocytose
sleep	slaap 
synapse	synaps
arrhythmia	hartritmestoornis
epirus	epirus 
ascomycota	ascomyceten
hinduism	hindoeïsme
