auriculo-ventriculaires	atrioventricular
québec	québec
métabolisme	metabolism
peropératoires	perioperative
pathologiques	pathological
congénital	congenital
organique	organic
angine	angina
sensibilité	sensitivity
parasympathique	parasympathetic
aortique	aortic
congénitaux	congenital
cérébraux	cerebral
cardiaques	cardiac
hypertensions	hypertension
diagnostiqués	diagnosed
mitrales	mitral
apex	apex
métaboliques	metabolic
aldostérone	aldosterone
collagène	collagen
diagnostiquée	diagnosed
pronostique	prognostic
pouls	pulse
chirurgien	surgeons
implanté	implanted
significatif	significant
sténoses	stenosis
arthrites	arthritis
électrolytes	electrolytes
adénovirus	adenovirus
dysfonctionnement	dysfunction
injection	injections
hypertrophique	hypertrophic
placebo	placebo
cerveau	brain
calcineurine	calcineurin
santé	health
néprilysine	neprilysin
décompensation	decompensation
extracellulaire	extracellular
protéomique	proteomic
biopsie	biopsies
thromboses	thrombosis
europe	europe
cardiogène	cardiogenic
pathologie	pathology
nésiritide	nesiritide
hospitalisés	hospitalized
phosphodiestérases	pde
sains	healthy
échographie-doppler	echo-doppler
diagnostiques	diagnostic
hypoxies	hypoxia
medicaux	medical
stables	stable
échocardiagraphique	echocardiographic
radiologiques	radiological
thromboemboliques	thromboembolic
revascularisation	revascularization
insuline	insulin
ambulatoire	ambulatory
prescrits	prescribed
angor	angina
ischémiques	ischemic
hémorragies	bleeding
ischémique	ischemic
myocardites	myocarditis
génique	genetic
angiotensine	angiotensin
chirurgiens	surgeons
interventriculaire	interventricular
cerebrovasculaire	cerebrovascular
irm	mri
circulatoire	circulatory
cérébrale	cerebral
artériels	arterial
perfusion	perfusion
myofibrillaire	myofibrillar
télésystoliques	end-systolic
contractilité	contractility
arthrite	arthritis
préopératoires	preoperative
charm	charm
artérielles	arterial
échocardiographiques	echocardiographic
cardiologues	cardiologists
ivabradine	ivabradine
hypertensive	hypertensive
biventriculaires	biventricular
thorax	chest
artérielle	arterial
obèse	obese
prospectives	prospective
rénales	renal
anticoagulants	anticoagulants
physiques	physical
poumon	lung
hypertrophie	hypertrophy
hémorragie	bleeding
dilatées	dilated
physiopathologie	pathophysiology
infracellulaires	intracellular
périopératoires	perioperative
dobutamine	dobutamine
percutanées	percutaneous
post-charge	afterload
injections	injections
neurologique	neurological
prévalences	prevalence
significatives	significant
foie	liver
anticorps	antibodies
neurologiques	neurological
pathophysiologie	pathophysiology
médecine	medicine
épidémie	epidemic
compliance	compliance
pulmonaires	pulmonary
cardique	cardiac
significativement	significantly
hématopoïétiques	haematopoietic
strain	strain
inflammation	inflammation
hospitalisées	hospitalized
spécificité	specificity
chimiothérapie	chemotherapy
systémique	systemic
natriurétique	natriuretic
diabétique	diabetic
hypertensif	hypertensive
fibrose	fibrosis
noradrénaline	norepinephrine
hospitalisée	hospitalized
abdominales	abdominal
rénine	renin
hypertendu	hypertensive
aiguës	acute
vo2	vo2
athérosclérose	atherosclerosis
sodium	sodium
cardiogénique	cardiogenic
immunohistochimiques	immunohistochemistry
réadaptation	rehabilitation
prescription	prescription
chirurgicalement	surgically
péri-opératoire	perioperative
r	r
thrombo-emboliques	thromboembolic
norépinéphrine	norepinephrine
aigu	acute
atp	atp
implantés	implanted
pathologies	pathology
diagnostiquer	diagnosed
curatifs	curative
veineuse	venous
infections	infection
diastolique	diastolic
électrocardiographique	electrocardiographic
étiologiques	etiologic
adrénoméduline	adrenomedullin
héréditaire	hereditary
congénitales	congenital
adénoviraux	adenoviral
réentraînement	rehabilitation
préopératoire	preoperative
oral	oral
hypotension	hypotension
anticoagulant	anticoagulants
atrioventriculaire	atrioventricular
auriculaire	atrial
auriculoventriculaire	atrioventricular
furosémide	furosemide
génétique	genetic
postcharge	afterload
obésité	obesity
doppler	doppler
systémiques	systemic
canada	canada
septale	septal
hyponatrémie	hyponatremia
cardiotoxicité	cardiotoxicity
hypertension	hypertension
adénosine	adenosine
chronique	chronic
asymptomatique	asymptomatic
aiguë	acute
étiologique	etiologic
dilatée	dilated
ventriculaire	ventricular
rein	kidney
mitral	mitral
auscultation	auscultation
hospitalisé	hospitalized
cardiologue	cardiologists
infection	infection
symptomatique	symptomatic
saines	healthy
chimiothérapies	chemotherapy
cardiaque	cardiac
implantable	implantable
pulmonaire	pulmonary
mitrale	mitral
diagnostiquées	diagnosed
pronostic	prognosis
hypertensives	hypertensive
phosphorylation	phosphorylation
cérébrales	cerebral
paradigm-hf	paradigm-hf
prescriptions	prescription
médicalement	medically
hypo-albuminémie	hypoalbuminemia
av	atrioventricular
apoptose	apoptosis
périopératoire	perioperative
systoliques	systolic
dysfonctions	dysfunction
génétiques	genetic
congénitale	congenital
aigus	acute
chroniques	chronic
asymptomatiques	asymptomatic
médicales	medical
reins	kidney
veineux	venous
atrioventriculaires	atrioventricular
plasma	plasma
prospective	prospective
artériel	arterial
organes	organ
auriculoventriculaires	atrioventricular
cliniquement	clinically
myocardique	myocardial
ambulatoires	ambulatory
médical	medical
électrocardiographiques	electrocardiographic
glucose	glucose
vasculaire	vascular
cachexie	cachexia
angiographie	angiography
circulation	circulation
idiopathique	idiopathic
nyha	nyha
repolarisation	repolarization
artériellle	arterial
symptomatiques	symptomatic
spironolactone	spironolactone
fibrilation	fibrillation
sepsis	sepsis
écho-doppler	echo-doppler
cardiologie	cardiology
idiopathiques	idiopathic
macrophages	macrophages
implantables	implantable
valvulaire	valvular
coronarien	coronary
sympathique	sympathetic
implantée	implanted
endopeptidase	endopeptidase
ablation	ablation
fibrillation	fibrillation
inflammatoire	inflammatory
contractile	contractile
coronarienne	coronary
obèses	obese
sang	blood
angioplastie	angioplasty
palliative	palliative
anticoagulation	anticoagulation
génomique	genomic
percutanée	percutaneous
endothéliale	endothelial
physiologie	physiology
incidence	incidence
médicaux	medical
cytotoxiques	cytotoxic
hf-action	hf-action
bisoprolol	bisoprolol
mitraux	mitral
natriurétiques	natriuretic
cardiotoxicity	cardiotoxicity
hypertendus	hypertensive
chambre	chamber
valvulaires	valvular
systolique	systolic
vasculaires	vascular
organiques	organic
significative	significant
bolus	bolus
péri-opératoires	perioperative
pubmed	pubmed
cardiopulmonaire	cardiopulmonary
endothéliales	endothelial
aortiques	aortic
anémie	anemia
tricuspidien	tricuspid
prévalence	prevalence
pronosgtic	prognosis
troponine	troponin
endothélial	endothelial
sténose	stenosis
épidémiologie	epidemiology
physique	physical
baroréflexe	baroreflex
créatinine	creatinine
stable	stable
hta	hypertension
myocardiques	myocardial
terminal	terminal
framingham	framingham
auriculaires	atrial
échocardiographique	echocardiographic
dilaté	dilated
pronostiques	prognostic
contractiles	contractile
cérébral	cerebral
pioglitazone	pioglitazone
oreillette	atrium
vasodilatatrice	vasodilatory
tunel	tunel
diastole	diastole
diagnostique	diagnostic
diabétiques	diabetic
trastuzumab	trastuzumab
biventriculaire	biventricular
endothéline	endothelin
auriculo-ventriculaire	atrioventricular
epidémiologie	epidemiology
internistes	internists
coronariens	coronary
diastoliques	diastolic
significatifs	significant
orale	oral
thrombose	thrombosis
rénale	renal
protéolyse	proteolysis
circulatoires	circulatory
biopsies	biopsies
musculaires	muscular
neurohumorale	neurohumoral
testostérone	testosterone
hyponatrémies	hyponatremia
diabètique	diabetic
immunoglobuline	antibodies
médicale	medical
palliatifs	palliative
dialyse	dialysis
rénal	renal
terminale	terminal
oreillettes	atrium
dysfonction	dysfunction
hypoxie	hypoxia
thromboembolique	thromboembolic
myocardite	myocarditis
hypertrophier	hypertrophied
at1	at1
atriale	atrial
peropératoire	perioperative
ventriculaires	ventricular
valsartan	valsartan
musculaire	muscular
septal	septal
explanter	explanted
organe	organ
radiologique	radiological
capillaire	capillary
cardiopulmonaires	cardiopulmonary
heartmate	heartmate
antitumoraux	antitumor
